GTTGATTAACACTCCACTG: TTGATTAACACTCCACTGG
GCGTAAGACTCTTGATCGG: CGTAAGACTCTTGATCGGA
AGGCCGCAATCAGGCCTCG: GGCCGCAATCAGGCCTCGC
GACTACTAATGCATTAGAT: ACTACTAATGCATTAGATG
AGAGACCGCATGAGAATGG: GAGACCGCATGAGAATGGT
AGGCGTGCGAAGAGTAGAA: GGCGTGCGAAGAGTAGAAC
GTCCTTGTTCTAGAACGCG: TCCTTGTTCTAGAACGCGG
TAGCTCTATGCTTCGTCCA: AGCTCTATGCTTCGTCCAG
ATTGGAGTCTAGATCTCCG: TTGGAGTCTAGATCTCCGC
CTGAAAGAGGCTTCGGCCG: TGAAAGAGGCTTCGGCCGT
TCGCTGTCGCGTGGTGACA: CGCTGTCGCGTGGTGACAG
GCAAAGATCCAGTCCCTTG: CAAAGATCCAGTCCCTTGA
TGATCCTTAAGACCGTCCT: GATCCTTAAGACCGTCCTG
TAGCGCATTGCATAGCTCT: AGCGCATTGCATAGCTCTA
CTAGACTATGAGACTTAAA: TAGACTATGAGACTTAAAG
AAAGAGCGTTTTACTACCT: AAGAGCGTTTTACTACCTC
CCTCTATCGGCTGAATTAA: CTCTATCGGCTGAATTAAA
ACCATATGCTGTTCACCAC: CCATATGCTGTTCACCACT
GCGTTGCTTAGTTAGAACC: CGTTGCTTAGTTAGAACCC
TTCTCTAGGATATAGCCCC: TCTCTAGGATATAGCCCCT
CTTGATCGGAAAGTTGGAG: TTGATCGGAAAGTTGGAGC
GCACTTCGCGGTCTCGGTC: CACTTCGCGGTCTCGGTCA
GGCCGTGATCCACAGGCGT: GCCGTGATCCACAGGCGTG
GGTATAGAGGAGAACGATC: GTATAGAGGAGAACGATCT
ACACATGCGCTCGACCTCC: CACATGCGCTCGACCTCCC
TACCTACGAGACCGAGCCA: ACCTACGAGACCGAGCCAC
ATGAGACTTAAAGAGCGTT: TGAGACTTAAAGAGCGTTC TGAGACTTAAAGAGCGTTA TGAGACTTAAAGAGCGTTT TGAGACTTAAAGAGCGTTA
ACTTGCTTTCGTGAGGTAG: CTTGCTTTCGTGAGGTAGA
TGTTGATTAACACTCCACT: GTTGATTAACACTCCACTG
TGTGCTGACTGACTCAAAG: GTGCTGACTGACTCAAAGT
TAGCGAAGTTTCTGAAAGA: AGCGAAGTTTCTGAAAGAG
AGCTAGACTATGAGACTTA: GCTAGACTATGAGACTTAA
CAAGCCTTCTTTCACGATT: AAGCCTTCTTTCACGATTT
TGTGACAGAGGAAGCCGTG: GTGACAGAGGAAGCCGTGT
AGGGTTTCAATGACCTTTC: GGGTTTCAATGACCTTTCA
ACCTCCCTGTAGGTATCTT: CCTCCCTGTAGGTATCTTT
TCAGGCCTCGCACAGCAAA: CAGGCCTCGCACAGCAAAG
CCAACTTGCTTTCGTGAGG: CAACTTGCTTTCGTGAGGT
TGCGGCTGGGCACTTCGCG: GCGGCTGGGCACTTCGCGG
AACAACATAACCGTTTTGC: ACAACATAACCGTTTTGCC
GACGGAAGCCTCCTGATCT: ACGGAAGCCTCCTGATCTA
GCCGTGTACCTTCACGAGC: CCGTGTACCTTCACGAGCG
TCAACTCTACATTACGCAT: CAACTCTACATTACGCATC
TAAGGCAATTACGGCGCTA: AAGGCAATTACGGCGCTAG
TTCTCGTCTACAGGCCGCA: TCTCGTCTACAGGCCGCAA
TTCAATGTACCTACGAGAC: TCAATGTACCTACGAGACC
CATATGCTGTTCACCACTA: ATATGCTGTTCACCACTAG
TGCTAGCCGAAACGAACCC: GCTAGCCGAAACGAACCCG
TCGTACCTTAACGGACCTG: CGTACCTTAACGGACCTGC
TCACCACTAGCGCATTGCA: CACCACTAGCGCATTGCAT
GATCGGAAAGTTTATTGCC: ATCGGAAAGTTTATTGCCG
CTGACTCAAAGTGTGACAG: TGACTCAAAGTGTGACAGA
AAGTGCACGCTGTGTGGCA: AGTGCACGCTGTGTGGCAG
CGGCCTGGCACCAACTTGC: GGCCTGGCACCAACTTGCT
TATGCTTCGTCCAGCCTCC: ATGCTTCGTCCAGCCTCCG
TTCGAACCTGGGGAGACGC: TCGAACCTGGGGAGACGCT
AAGGGGTAGCGTCCTTTTC: AGGGGTAGCGTCCTTTTCC
ACAACATAACCGTTTTGCC: CAACATAACCGTTTTGCCT
CACACCGACAAACTGAGAC: ACACCGACAAACTGAGACG
TCTTTCACGATTTACGGTC: CTTTCACGATTTACGGTCC
GCACTCTTGATCGGAAAGT: CACTCTTGATCGGAAAGTT
TCTCCGAGAGTACTCTTGA: CTCCGAGAGTACTCTTGAT
ACCGCTACTCGATTCAAGG: CCGCTACTCGATTCAAGGT
TAGGCTTAAACTAGTTAAG: AGGCTTAAACTAGTTAAGT
ATGCTTCGTCCAGCCTCCG: TGCTTCGTCCAGCCTCCGG
ACCCAGCTATTCGGACCGC: CCCAGCTATTCGGACCGCT
CTTTCGTGAGGTAGATCCC: TTTCGTGAGGTAGATCCCT
ACAGCGTGATGAGACTTAA: CAGCGTGATGAGACTTAAA
AGCTATCACGGGTGGGACT: GCTATCACGGGTGGGACTA
TAAAGTCAAGTTAGACTAG: AAAGTCAAGTTAGACTAGT
ATAGAACTCTTGATCGGAA: TAGAACTCTTGATCGGAAA
GTACCACCACACTCCGATG: TACCACCACACTCCGATGC
AGCCACGAGGAAAAAACTT: GCCACGAGGAAAAAACTTG
TCTATCGGCTGAATTAAAC: CTATCGGCTGAATTAAACA
ACAGGCCGCAATCAGGCCT: CAGGCCGCAATCAGGCCTC
TCATCAGCTATCACGGGTG: CATCAGCTATCACGGGTGG
CGGCTGGGCACTTCGCGGT: GGCTGGGCACTTCGCGGTC
CTGCAGTGAGGTTTGATCG: TGCAGTGAGGTTTGATCGG
CAGGTCTGCGGTGATAGAA: AGGTCTGCGGTGATAGAAG
GAACCCAGCTATTCGGACC: AACCCAGCTATTCGGACCG
TAGATCCCTCTGCGCATCC: AGATCCCTCTGCGCATCCT
AAAGTGCACGCTGTGTGGC: AAGTGCACGCTGTGTGGCA
ACCAACGGGCGCGAGTAGT: CCAACGGGCGCGAGTAGTC
GACTTAAAGAGCGTTCCAG: ACTTAAAGAGCGTTCCAGC
TAGAGTTGGCACTCTTGAT: AGAGTTGGCACTCTTGATC
CCTCCCTGTAGGTATCTTT: CTCCCTGTAGGTATCTTTC
CATGCGCTCGACCTCCCTG: ATGCGCTCGACCTCCCTGT
AGTTAGTCAAGCCGGTTAG: GTTAGTCAAGCCGGTTAGC
ATCGTTCCCTGCAGTGAGG: TCGTTCCCTGCAGTGAGGT
AATTAAACATGCGCTGCAG: ATTAAACATGCGCTGCAGT
GATTTACTCAGCGGTGTTC: ATTTACTCAGCGGTGTTCG
AGAATGGTTCGGCAAGGTA: GAATGGTTCGGCAAGGTAC
GGGACTAATGAACACCGAT: GGACTAATGAACACCGATT
GGTCAGGTCTGCGGTGATA: GTCAGGTCTGCGGTGATAG
TTTTGCCTGGAGGATGAAC: TTTGCCTGGAGGATGAACG
TTAAACATGCGCTGCAGTA: TAAACATGCGCTGCAGTAC
CGCATGAGAATGGTTCGGC: GCATGAGAATGGTTCGGCA
CGATGACGGAAGCCTCCTG: GATGACGGAAGCCTCCTGA
CACACTAAGGCAATTACGG: ACACTAAGGCAATTACGGC
CACTAGACGTAAGCACAGG: ACTAGACGTAAGCACAGGT
TCAATTGAGCCGTGATGTA: CAATTGAGCCGTGATGTAG
TTGGAAAGGGCAGTCTCGA: TGGAAAGGGCAGTCTCGAT
AATCGTCATCCCGTACACG: ATCGTCATCCCGTACACGT
GTCCAAACTAGAGTTGGCA: TCCAAACTAGAGTTGGCAC
CTTGATCGGAAAGTTACGC: TTGATCGGAAAGTTACGCC
TAAATCCGGGAAGTGCGCG: AAATCCGGGAAGTGCGCGT
AGAGTTGGCACTCTTGATC: GAGTTGGCACTCTTGATCG
TTTCGCACCCTTCAACTCT: TTCGCACCCTTCAACTCTA
GAGACGCTGGTCGGCTCAC: AGACGCTGGTCGGCTCACA
ACTAAAGTCAAGTTAGACT: CTAAAGTCAAGTTAGACTA
CGGAAAGTTACGCCCCATA: GGAAAGTTACGCCCCATAC
ATCCAGTCCCTTGACACTA: TCCAGTCCCTTGACACTAG
CCGATTGCTGCTAGCCGAA: CGATTGCTGCTAGCCGAAA
ACATAACCGTTTTGCCTGG: CATAACCGTTTTGCCTGGA
CGCCGATGAGACTTAAAGA: GCCGATGAGACTTAAAGAG
GCCGATGAGACTTAAAGAG: CCGATGAGACTTAAAGAGC
CACGCTATCGTACCTTAAC: ACGCTATCGTACCTTAACG
GATCCCTCTGCGCATCCTA: ATCCCTCTGCGCATCCTAG
CGGCCGTGATCCACAGGCG: GGCCGTGATCCACAGGCGT
GCTCAGCGTGCCACACTGA: CTCAGCGTGCCACACTGAC
ACCTCATTCGTTCGCACAA: CCTCATTCGTTCGCACAAA
GCCTGGTCAACTGGTATGT: CCTGGTCAACTGGTATGTC
ACCGCTTGACACACCGACA: CCGCTTGACACACCGACAA
CTTCGTCCAGCCTCCGGCT: TTCGTCCAGCCTCCGGCTG
GTCCTCTAGATCCTGTGTA: TCCTCTAGATCCTGTGTAC
CCCATACATGAGACTTAAA: CCATACATGAGACTTAAAG
AGCGGTGTTCGATCTATTG: GCGGTGTTCGATCTATTGG
TAGTTAAGTAGAAAGTTGT: AGTTAAGTAGAAAGTTGTG
GTTTTGACTGATCCTTAAG: TTTTGACTGATCCTTAAGA
GCACCATATGCTGTTCACC: CACCATATGCTGTTCACCA
GGTAGTCAGTACCACCACA: GTAGTCAGTACCACCACAC
CGGCGCTAGCAAAGATCCA: GGCGCTAGCAAAGATCCAG
TTCAATATCGTCTTTCGCT: TCAATATCGTCTTTCGCTG
GACAGGACGAGTGTCTGGC: ACAGGACGAGTGTCTGGCC
TCCGGTTTTGAGGACATAC: CCGGTTTTGAGGACATACC
TTTGGAAAGGGCAGTCTCG: TTGGAAAGGGCAGTCTCGA
ACTAGTTAAGTAGAAAGTT: CTAGTTAAGTAGAAAGTTG
ATGCGCTCGACCTCCCTGT: TGCGCTCGACCTCCCTGTA
TTTCCAAGCGTCGGGTGGT: TTCCAAGCGTCGGGTGGTA
TACACGTATTTCTCTAGGA: ACACGTATTTCTCTAGGAT
CGATCTTGAACGCTCGAAA: GATCTTGAACGCTCGAAAT
TGTTCGATCTATTGGAGTC: GTTCGATCTATTGGAGTCT
TTTGGTCGAACCCAGCTAT: TTGGTCGAACCCAGCTATT
GCGTCGGGTGGTATACACC: CGTCGGGTGGTATACACCG
GAAATTTGTGAGACATCCT: AAATTTGTGAGACATCCTC
AAAACTTGGCTTCTATCGT: AAACTTGGCTTCTATCGTT
CTGACTGACTCAAAGTGTG: TGACTGACTCAAAGTGTGA
ACTGATCCTTAAGACCGTC: CTGATCCTTAAGACCGTCC
CCTGTGTACTGCCGATACA: CTGTGTACTGCCGATACAA
GGCTGGGCACTTCGCGGTC: GCTGGGCACTTCGCGGTCT
GCACACTAAGGCAATTACG: CACACTAAGGCAATTACGG
AGGTACATCTCCTGGAACT: GGTACATCTCCTGGAACTG
ATTATTCGCCTACGATCAG: TTATTCGCCTACGATCAGT
CTTCAACTCTACATTACGC: TTCAACTCTACATTACGCA
CTGATAATCGTCATCCCGT: TGATAATCGTCATCCCGTA
AGACGTAAGCACAGGTCCA: GACGTAAGCACAGGTCCAA
ATCGTCATCCCGTACACGT: TCGTCATCCCGTACACGTA
CGTGATGAGACTTAAAGAG: GTGATGAGACTTAAAGAGC
TAACCGCTACTCGATTCAA: AACCGCTACTCGATTCAAG
CGTCCTTTTCCTTTCTCTA: GTCCTTTTCCTTTCTCTAG
GATCGGAAAGTTCAAACAG: ATCGGAAAGTTCAAACAGC
CTAGTGGGTAGTCAGTACC: TAGTGGGTAGTCAGTACCA
GCCACGAACACATGCGCTC: CCACGAACACATGCGCTCG
CTAGATCTCCGCTGAAACG: TAGATCTCCGCTGAAACGG
CCGTTTTGCCTGGAGGATG: CGTTTTGCCTGGAGGATGA
AGCTCCATCAAGCCTTCTT: GCTCCATCAAGCCTTCTTT
ATTCAAGGTTATTTGGAAA: TTCAAGGTTATTTGGAAAG
GGTTTCAATGACCTTTCAA: GTTTCAATGACCTTTCAAT
CTATCGTTCCCTGCAGTGA: TATCGTTCCCTGCAGTGAG
CTGTGCTGACTGACTCAAA: TGTGCTGACTGACTCAAAG
GAACTGGTAACTTCGAACC: AACTGGTAACTTCGAACCT
AGTTTTGACTGATCCTTAA: GTTTTGACTGATCCTTAAG
CCGCTACTCGATTCAAGGT: CGCTACTCGATTCAAGGTT
GAGCCGTGATGTAGGAAAA: AGCCGTGATGTAGGAAAAG
TCAATAACCGCTACTCGAT: CAATAACCGCTACTCGATT
TTGAGGACATACCAACGGG: TGAGGACATACCAACGGGC
CCAGTCCCTTGACACTAGA: CAGTCCCTTGACACTAGAC
TAATCGTCATCCCGTACAC: AATCGTCATCCCGTACACG
TGCGTTGCTTAGTTAGAAC: GCGTTGCTTAGTTAGAACC
GCTTCGGCCGTGATCCACA: CTTCGGCCGTGATCCACAG
TTTGATCGGGTCTGTCTCG: TTGATCGGGTCTGTCTCGC
GGGTGGTATACACCGTAGG: GGTGGTATACACCGTAGGC
TCGTTCCCTGCAGTGAGGT: CGTTCCCTGCAGTGAGGTT
CACGGGTGGGACTAATGAA: ACGGGTGGGACTAATGAAC
CGTTCCAGCGCGTTTTCCA: GTTCCAGCGCGTTTTCCAA
TACATGAGACTTAAAGAGC: ACATGAGACTTAAAGAGCG
GACTGATAATCGTCATCCC: ACTGATAATCGTCATCCCG
GCTTGTGCGGCTGCGTAAG: CTTGTGCGGCTGCGTAAGA
ATCCCTCTGCGCATCCTAG: TCCCTCTGCGCATCCTAGA
CCTTCAACTCTACATTACG: CTTCAACTCTACATTACGC
AAGAGTAGAACGGTAGATG: AGAGTAGAACGGTAGATGT
AAAGTGTGACAGAGGAAGC: AAGTGTGACAGAGGAAGCC
CGCTGAAACGGTATATCGG: GCTGAAACGGTATATCGGG
GCTGAATTAAACATGCGCT: CTGAATTAAACATGCGCTG
TCCCTGCAGTGAGGTTTGA: CCCTGCAGTGAGGTTTGAT
ACTGCTCAGCGTGCCACAC: CTGCTCAGCGTGCCACACT
CGCTGTCGCGTGGTGACAG: GCTGTCGCGTGGTGACAGG
AGGAAGCCGTGTACCTTCA: GGAAGCCGTGTACCTTCAC
CAGCTCCATCAAGCCTTCT: AGCTCCATCAAGCCTTCTT
CTTAAAGAGCGTTTTACTA: TTAAAGAGCGTTTTACTAC
CAAGGTTATTTGGAAAGGG: AAGGTTATTTGGAAAGGGC
GATCGGAAAGTTACGCCCC: ATCGGAAAGTTACGCCCCA
AAACATGCGCTGCAGTACT: AACATGCGCTGCAGTACTT
CGACAAACTGAGACGACTA: GACAAACTGAGACGACTAC
CTGCGGTGATAGAAGCCAC: TGCGGTGATAGAAGCCACG
ACATCTCCTGGAACTGGTA: CATCTCCTGGAACTGGTAA
TTAACGGACCTGCTTGTGC: TAACGGACCTGCTTGTGCG
TGAGCCGTGATGTAGGAAA: GAGCCGTGATGTAGGAAAA
CTAGCAAAGATCCAGTCCC: TAGCAAAGATCCAGTCCCT
TTCACCACTAGCGCATTGC: TCACCACTAGCGCATTGCA
CATTAGATGACTCAATTGA: ATTAGATGACTCAATTGAG
GAGAGGATTTACTCAGCGG: AGAGGATTTACTCAGCGGT
CCGACGACACGTAACAGTT: CGACGACACGTAACAGTTG
TGGCACAATTCGCGAGGTC: GGCACAATTCGCGAGGTCC
TTGCCTGGAGGATGAACGG: TGCCTGGAGGATGAACGGA
CCTTTTCCTTTCTCTAGTG: CTTTTCCTTTCTCTAGTGG
CGATGAGACTTAAAGAGCG: GATGAGACTTAAAGAGCGT
GGTGATAGAAGCCACGAGG: GTGATAGAAGCCACGAGGA
CGGGAAGTGCGCGTCCGGT: GGGAAGTGCGCGTCCGGTG
AGTCAAGCCGGTTAGCGAA: GTCAAGCCGGTTAGCGAAG
TGAACGCTCGAAATTTGTG: GAACGCTCGAAATTTGTGA
ACTTAAAGAGCGTTACTGC: CTTAAAGAGCGTTACTGCT
GAACGGATTATTCGCCTAC: AACGGATTATTCGCCTACG
GAAAAGCGTCCGACGACAC: AAAAGCGTCCGACGACACG
TTCGATCTATTGGAGTCTA: TCGATCTATTGGAGTCTAG
AACCTGGGGAGACGCTGGT: ACCTGGGGAGACGCTGGTC
ACGCATCCTCCGGTTTTGA: CGCATCCTCCGGTTTTGAG
GTCTCGGTATATCGCAAAG: TCTCGGTATATCGCAAAGA
CGTCCTGTGCTGACTGACT: GTCCTGTGCTGACTGACTC
GGCCTGGCACCAACTTGCT: GCCTGGCACCAACTTGCTT
GTAGGTATCTTTCGGTACC: TAGGTATCTTTCGGTACCA
CCGCAATCAGGCCTCGCAC: CGCAATCAGGCCTCGCACA
CTAATGAACACCGATTTGG: TAATGAACACCGATTTGGT
GGTCTGCGGTGATAGAAGC: GTCTGCGGTGATAGAAGCC
CACTAAAGTCAAGTTAGAC: ACTAAAGTCAAGTTAGACT
ATTCGCCTACGATCAGTTT: TTCGCCTACGATCAGTTTG
GAGACTTAAAGAGCGTTAA: AGACTTAAAGAGCGTTAAA
GAGTAGAACGGTAGATGTT: AGTAGAACGGTAGATGTTG
CGTACACGTATTTCTCTAG: GTACACGTATTTCTCTAGG
CTCTAGGATATAGCCCCTG: TCTAGGATATAGCCCCTGC
CTCCTGGCACAATTCGCGA: TCCTGGCACAATTCGCGAG
GACGTAAGCTTGTTCTCGT: ACGTAAGCTTGTTCTCGTC
CCTGGAACTGGTAACTTCG: CTGGAACTGGTAACTTCGA
TCGCGGTCTCGGTCATCAG: CGCGGTCTCGGTCATCAGC
TGAGAATGGTTCGGCAAGG: GAGAATGGTTCGGCAAGGT
ATCCTGTGTACTGCCGATA: TCCTGTGTACTGCCGATAC
GATGTAGGAAAAGCGTCCG: ATGTAGGAAAAGCGTCCGA
GTTCACCACTAGCGCATTG: TTCACCACTAGCGCATTGC
TCTCGTCTACAGGCCGCAA: CTCGTCTACAGGCCGCAAT
CTGGATGTCAATAACCGCT: TGGATGTCAATAACCGCTA
AGAGGATTTACTCAGCGGT: GAGGATTTACTCAGCGGTG
ACTGACCCAGACTGATAAT: CTGACCCAGACTGATAATC
CCGGGAAGTGCGCGTCCGG: CGGGAAGTGCGCGTCCGGT
AACCCAGCTATTCGGACCG: ACCCAGCTATTCGGACCGC
CTAATGCATTAGATGACTC: TAATGCATTAGATGACTCA
AACTTGCTTTCGTGAGGTA: ACTTGCTTTCGTGAGGTAG
TTTATTGCCGCCGATGAGA: TTATTGCCGCCGATGAGAC
GTTAAGTAGAAAGTTGTGC: TTAAGTAGAAAGTTGTGCG
GCTCACACGACAATAGAAC: CTCACACGACAATAGAACT
TTCCTTTCTCTAGTGGGTA: TCCTTTCTCTAGTGGGTAG
CCCCATACATGAGACTTAA: CCCATACATGAGACTTAAA
GACAAACTGAGACGACTAC: ACAAACTGAGACGACTACA
TTATTCGCCTACGATCAGT: TATTCGCCTACGATCAGTT
ATATCGGGCACACTAAGGC: TATCGGGCACACTAAGGCA
TTTCTCTAGGATATAGCCC: TTCTCTAGGATATAGCCCC
GTGTGGCAGTACCCTACCT: TGTGGCAGTACCCTACCTA
AGAGCGTTAAACAACATAA: GAGCGTTAAACAACATAAC
CAGTTTGTCACGGACGTAA: AGTTTGTCACGGACGTAAG
AGTGCACGCTGTGTGGCAG: GTGCACGCTGTGTGGCAGT
AAAGTTACGCCCCATACAT: AAGTTACGCCCCATACATG
GACCGAGCCACGAACACAT: ACCGAGCCACGAACACATG
CTTAAACTAGTTAAGTAGA: TTAAACTAGTTAAGTAGAA
TTCGGCCGTGATCCACAGG: TCGGCCGTGATCCACAGGC
CAGGCCTCGCACAGCAAAG: AGGCCTCGCACAGCAAAGT
TGCTGTTCACCACTAGCGC: GCTGTTCACCACTAGCGCA
AGAACGATCTTGAACGCTC: GAACGATCTTGAACGCTCG
CTCTATGCTTCGTCCAGCC: TCTATGCTTCGTCCAGCCT
TAGATGTTGATTAACACTC: AGATGTTGATTAACACTCC
TAGCAAAGATCCAGTCCCT: AGCAAAGATCCAGTCCCTT
GAAACGTAACAGCACGCCA: AAACGTAACAGCACGCCAA
GGTCATCAGCTATCACGGG: GTCATCAGCTATCACGGGT
GCAATTACGGCGCTAGCAA: CAATTACGGCGCTAGCAAA
AGCGTTCCAGCGCGTTTTC: GCGTTCCAGCGCGTTTTCC
ACAATAGAACTCTTGATCG: CAATAGAACTCTTGATCGG
ACAGGACGAGTGTCTGGCC: CAGGACGAGTGTCTGGCCA
ATTTGGTCGAACCCAGCTA: TTTGGTCGAACCCAGCTAT
GTGCGTTGCTTAGTTAGAA: TGCGTTGCTTAGTTAGAAC
TCGAACCCAGCTATTCGGA: CGAACCCAGCTATTCGGAC
CGCACCCTTCAACTCTACA: GCACCCTTCAACTCTACAT
CTATTGGAGTCTAGATCTC: TATTGGAGTCTAGATCTCC
AGCGTTTTACTACCTCATT: GCGTTTTACTACCTCATTC
CAGTCCCTTGACACTAGAC: AGTCCCTTGACACTAGACG
GCAGTACTTCTGGATGTCA: CAGTACTTCTGGATGTCAA
AACGGACCTGCTTGTGCGG: ACGGACCTGCTTGTGCGGC
AATAGAACTCTTGATCGGA: ATAGAACTCTTGATCGGAA
CTTCGCGGTCTCGGTCATC: TTCGCGGTCTCGGTCATCA
CTGCGAAACGTAACAGCAC: TGCGAAACGTAACAGCACG
CCTTTCTCTAGTGGGTAGT: CTTTCTCTAGTGGGTAGTC
GAACGCTCGAAATTTGTGA: AACGCTCGAAATTTGTGAG
TCACCTGACTGTACCGCAT: CACCTGACTGTACCGCATC
CAAGCGTCGGGTGGTATAC: AAGCGTCGGGTGGTATACA
CATTCGTTCGCACAAAATG: ATTCGTTCGCACAAAATGC
ACTCCTGGCACAATTCGCG: CTCCTGGCACAATTCGCGA
ATGCTGTTCACCACTAGCG: TGCTGTTCACCACTAGCGC
CGCTACTCGATTCAAGGTT: GCTACTCGATTCAAGGTTA
CGTCCAGCCTCCGGCTGCC: GTCCAGCCTCCGGCTGCCC
GAAGCCACGAGGAAAAAAC: AAGCCACGAGGAAAAAACT
GAGGCTTCGGCCGTGATCC: AGGCTTCGGCCGTGATCCA
AGAGCGTTTTACTACCTCA: GAGCGTTTTACTACCTCAT
AGCGTGATGAGACTTAAAG: GCGTGATGAGACTTAAAGA
TCGGGTCTGTCTCGCTATC: CGGGTCTGTCTCGCTATCT
TACTGCTGACTCCTGGCAC: ACTGCTGACTCCTGGCACA
GCGTTACACTAAAGTCAAG: CGTTACACTAAAGTCAAGT
CTTGGCTTCTATCGTTCCC: TTGGCTTCTATCGTTCCCT
CGTTCCCTGCAGTGAGGTT: GTTCCCTGCAGTGAGGTTT
CGATACAAGTAGTTCAATG: GATACAAGTAGTTCAATGT
AGCTCTATGCTTCGTCCAG: GCTCTATGCTTCGTCCAGC
GCAATCAGGCCTCGCACAG: CAATCAGGCCTCGCACAGC
CGCCTGGTCAACTGGTATG: GCCTGGTCAACTGGTATGT
TGGTCGGCTCACACGACAA: GGTCGGCTCACACGACAAT
CGCGGTCTCGGTCATCAGC: GCGGTCTCGGTCATCAGCT
GTTCTCGTCTACAGGCCGC: TTCTCGTCTACAGGCCGCA
CTTAAAGAGCGTTCCAGCG: TTAAAGAGCGTTCCAGCGC
ATGAGAATGGTTCGGCAAG: TGAGAATGGTTCGGCAAGG
CCCGATTGCTGCTAGCCGA: CCGATTGCTGCTAGCCGAA
AAGGGCAGTCTCGATTCTC: AGGGCAGTCTCGATTCTCC
GACCTTTCAATATCGTCTT: ACCTTTCAATATCGTCTTT
GCCTCGCACAGCAAAGTTT: CCTCGCACAGCAAAGTTTT
CTCACCACGATGACGGAAG: TCACCACGATGACGGAAGC
TGCCACACTGACCCAGACT: GCCACACTGACCCAGACTG
TTCGCGGTCTCGGTCATCA: TCGCGGTCTCGGTCATCAG
TTAAAGAGCGTTAAACAAC: TAAAGAGCGTTAAACAACA
GGTCCGTTTGAGACTACTA: GTCCGTTTGAGACTACTAA
TTCTATCGTTCCCTGCAGT: TCTATCGTTCCCTGCAGTG
TCACGATTTACGGTCCTCT: CACGATTTACGGTCCTCTA
CCGGCCTGGCACCAACTTG: CGGCCTGGCACCAACTTGC
CAAAGTGTGACAGAGGAAG: AAAGTGTGACAGAGGAAGC
GTGATAGAAGCCACGAGGA: TGATAGAAGCCACGAGGAA
GTCCGTTTGAGACTACTAA: TCCGTTTGAGACTACTAAT
ATTAGATGACTCAATTGAG: TTAGATGACTCAATTGAGC
AGTTGTGCGTCATATACCA: GTTGTGCGTCATATACCAA
GGGTAGTCAGTACCACCAC: GGTAGTCAGTACCACCACA
ATAAGCTTGTGCGGCTGCG: TAAGCTTGTGCGGCTGCGT
TCTCTAGTGGGTAGTCAGT: CTCTAGTGGGTAGTCAGTA
GCATAGCTCTATGCTTCGT: CATAGCTCTATGCTTCGTC
ACTCCGATGCACCATATGC: CTCCGATGCACCATATGCT
TTGATCGGGTCTGTCTCGC: TGATCGGGTCTGTCTCGCT
CGTCATATACCAAGTTTCG: GTCATATACCAAGTTTCGC
CTTGACACTAGACGTAAGC: TTGACACTAGACGTAAGCA
CACATGCGCTCGACCTCCC: ACATGCGCTCGACCTCCCT
AGGTCCGTTTGAGACTACT: GGTCCGTTTGAGACTACTA
GGGCACACTAAGGCAATTA: GGCACACTAAGGCAATTAC
AAGTAGAAAGTTGTGCGTC: AGTAGAAAGTTGTGCGTCA
TGCTTAGTTAGAACCCGAT: GCTTAGTTAGAACCCGATT
TAGAACCCGATTGCTGCTA: AGAACCCGATTGCTGCTAG
GGTCTGTCTCGCTATCTCA: GTCTGTCTCGCTATCTCAG
CTGAGGACGAAACTGCCAA: TGAGGACGAAACTGCCAAA
AGGGCAGTCTCGATTCTCC: GGGCAGTCTCGATTCTCCG
ATGTTGATTAACACTCCAC: TGTTGATTAACACTCCACT
TGCGAAGAGTAGAACGGTA: GCGAAGAGTAGAACGGTAG
GTAGAAAGTTGTGCGTCAT: TAGAAAGTTGTGCGTCATA
CTTTCAATATCGTCTTTCG: TTTCAATATCGTCTTTCGC
GAGTCTAGATCTCCGCTGA: AGTCTAGATCTCCGCTGAA
TTACGCCCCATACATGAGA: TACGCCCCATACATGAGAC
ACACGTAACAGTTGGTGTC: CACGTAACAGTTGGTGTCT
CACAAAATGCTTAAGGGGT: ACAAAATGCTTAAGGGGTA
GACCTCCCTGTAGGTATCT: ACCTCCCTGTAGGTATCTT
TTCAACTCTACATTACGCA: TCAACTCTACATTACGCAT
CGCAAAGAGACCGCATGAG: GCAAAGAGACCGCATGAGA
GAGCGTTCCAGCGCGTTTT: AGCGTTCCAGCGCGTTTTC
GGTCCTCTAGATCCTGTGT: GTCCTCTAGATCCTGTGTA
AGGCTTCGGCCGTGATCCA: GGCTTCGGCCGTGATCCAC
TCGGTACCAATAAGCTTGT: CGGTACCAATAAGCTTGTG
GACTCAATTGAGCCGTGAT: ACTCAATTGAGCCGTGATG
TGCCCTGTTCACCTGACTG: GCCCTGTTCACCTGACTGT
CAAAGATCCAGTCCCTTGA: AAAGATCCAGTCCCTTGAC
ACACTAAAGTCAAGTTAGA: CACTAAAGTCAAGTTAGAC
GTCACGGACGTAAGCTTGT: TCACGGACGTAAGCTTGTT
CAAAATGCTTAAGGGGTAG: AAAATGCTTAAGGGGTAGC
GGAAAGGGCAGTCTCGATT: GAAAGGGCAGTCTCGATTC
CGTATTTCTCTAGGATATA: GTATTTCTCTAGGATATAG
CAATAGAACTCTTGATCGG: AATAGAACTCTTGATCGGA
ACCTAGCGTTACACTAAAG: CCTAGCGTTACACTAAAGT
TATATCGCAAAGAGACCGC: ATATCGCAAAGAGACCGCA
CCATCAAGCCTTCTTTCAC: CATCAAGCCTTCTTTCACG
TGTGTGGCAGTACCCTACC: GTGTGGCAGTACCCTACCT
CGGCTCACACGACAATAGA: GGCTCACACGACAATAGAA
AAGTCAAGTTAGACTAGTG: AGTCAAGTTAGACTAGTGT
GTTTGATCGGGTCTGTCTC: TTTGATCGGGTCTGTCTCG
TTGCTTAGTTAGAACCCGA: TGCTTAGTTAGAACCCGAT
TAGTTAGTCAAGCCGGTTA: AGTTAGTCAAGCCGGTTAG
ATCGTACCTTAACGGACCT: TCGTACCTTAACGGACCTG
GAGCGTTACTGCTGACTCC: AGCGTTACTGCTGACTCCT
TGATCCACAGGCGTGCGAA: GATCCACAGGCGTGCGAAG
ACGCGGCTGAGGACGAAAC: CGCGGCTGAGGACGAAACT
TGACACTAGACGTAAGCAC: GACACTAGACGTAAGCACA
ACGGTCCTCTAGATCCTGT: CGGTCCTCTAGATCCTGTG
AATCAGGCCTCGCACAGCA: ATCAGGCCTCGCACAGCAA
GTTAGACTAGTGTTCACGC: TTAGACTAGTGTTCACGCT
AAGATCCAGTCCCTTGACA: AGATCCAGTCCCTTGACAC
GTACCTTAACGGACCTGCT: TACCTTAACGGACCTGCTT
GTTTATTGCCGCCGATGAG: TTTATTGCCGCCGATGAGA
AAGAGACCGCATGAGAATG: AGAGACCGCATGAGAATGG
TCCGACGACACGTAACAGT: CCGACGACACGTAACAGTT
AGCTTGTTCTCGTCTACAG: GCTTGTTCTCGTCTACAGG
ACCGCATCACCACTGCTCA: CCGCATCACCACTGCTCAG
CACTCCACTGGTCAGGTCT: ACTCCACTGGTCAGGTCTG
TAGGATATAGCCCCTGCGA: AGGATATAGCCCCTGCGAA
ATCTTTCGGTACCAATAAG: TCTTTCGGTACCAATAAGC
GATCCAGTCCCTTGACACT: ATCCAGTCCCTTGACACTA
TAAACAACATAACCGTTTT: AAACAACATAACCGTTTTG
CGTTTTACTACCTCATTCG: GTTTTACTACCTCATTCGT
GGCTTCTATCGTTCCCTGC: GCTTCTATCGTTCCCTGCA
TAGCGTCCTTTTCCTTTCT: AGCGTCCTTTTCCTTTCTC
AGTCATAGTTAGTCAAGCC: GTCATAGTTAGTCAAGCCG
CCAGCTATTCGGACCGCTT: CAGCTATTCGGACCGCTTG
AGATCCAGTCCCTTGACAC: GATCCAGTCCCTTGACACT
TTTGCCTGGAGGATGAACG: TTGCCTGGAGGATGAACGG
GGCTTCGGCCGTGATCCAC: GCTTCGGCCGTGATCCACA
ATTTCTCTAGGATATAGCC: TTTCTCTAGGATATAGCCC
AACATGCGCTGCAGTACTT: ACATGCGCTGCAGTACTTC
CCACGAGGAAAAAACTTGG: CACGAGGAAAAAACTTGGC
GAAAGTTTATTGCCGCCGA: AAAGTTTATTGCCGCCGAT
CTTCTTTCACGATTTACGG: TTCTTTCACGATTTACGGT
AGACTTAAAGAGCGTTCCA: GACTTAAAGAGCGTTCCAG
GTACTCTTGATCGGAAAGT: TACTCTTGATCGGAAAGTT
CGCAATCAGGCCTCGCACA: GCAATCAGGCCTCGCACAG
CTCGGTATATCGCAAAGAG: TCGGTATATCGCAAAGAGA
AATTACGGCGCTAGCAAAG: ATTACGGCGCTAGCAAAGA
ACCGTTTTGCCTGGAGGAT: CCGTTTTGCCTGGAGGATG
CAGCAAAGTTTTGACTGAT: AGCAAAGTTTTGACTGATC
TGCCAAAAGTGCACGCTGT: GCCAAAAGTGCACGCTGTG
ACTGGTATGTCTCACCACG: CTGGTATGTCTCACCACGA
AGTGCGCGTCCGGTGCGTT: GTGCGCGTCCGGTGCGTTG
GAGGACGAAACTGCCAAAA: AGGACGAAACTGCCAAAAG
GAAAGTTGGAGCTAGACTA: AAAGTTGGAGCTAGACTAT
TAGTCAAGCCGGTTAGCGA: AGTCAAGCCGGTTAGCGAA
TCATTCGTTCGCACAAAAT: CATTCGTTCGCACAAAATG
TATCTTTCGGTACCAATAA: ATCTTTCGGTACCAATAAG
ACTATGAGACTTAAAGAGC: CTATGAGACTTAAAGAGCG
AGGATTTACTCAGCGGTGT: GGATTTACTCAGCGGTGTT
GGCTGCGTAAGACTCTTGA: GCTGCGTAAGACTCTTGAT
AGACGCTGGTCGGCTCACA: GACGCTGGTCGGCTCACAC
GATTGCTGCTAGCCGAAAC: ATTGCTGCTAGCCGAAACG
TGCACGCTGTGTGGCAGTA: GCACGCTGTGTGGCAGTAC
CCAAGTTTCGCACCCTTCA: CAAGTTTCGCACCCTTCAA
TTCTCCGAGAGTACTCTTG: TCTCCGAGAGTACTCTTGA
AACTAGTTAAGTAGAAAGT: ACTAGTTAAGTAGAAAGTT
GTGTACCTTCACGAGCGAG: TGTACCTTCACGAGCGAGA
CAGCGTGCCACACTGACCC: AGCGTGCCACACTGACCCA
ACGGGTGGGACTAATGAAC: CGGGTGGGACTAATGAACA
CGTTACACTAAAGTCAAGT: GTTACACTAAAGTCAAGTT
AACGCGGCTGAGGACGAAA: ACGCGGCTGAGGACGAAAC
ACCGTAGGCTTAAACTAGT: CCGTAGGCTTAAACTAGTT
CCGAAGGGTTTCAATGACC: CGAAGGGTTTCAATGACCT
GGTAGCGTCCTTTTCCTTT: GTAGCGTCCTTTTCCTTTC
CGTCATCCCGTACACGTAT: GTCATCCCGTACACGTATT
CACCCTTCAACTCTACATT: ACCCTTCAACTCTACATTA
TTGGCTTCTATCGTTCCCT: TGGCTTCTATCGTTCCCTG
CTCCGGTTTTGAGGACATA: TCCGGTTTTGAGGACATAC
ATTGCTGCTAGCCGAAACG: TTGCTGCTAGCCGAAACGA
AGAACGGTAGATGTTGATT: GAACGGTAGATGTTGATTA
ACGACAATAGAACTCTTGA: CGACAATAGAACTCTTGAT
CGGTGTTCGATCTATTGGA: GGTGTTCGATCTATTGGAG
AACTGGTAACTTCGAACCT: ACTGGTAACTTCGAACCTG
TGGCACTCTTGATCGGAAA: GGCACTCTTGATCGGAAAG
GACGAGTGTCTGGCCAAGG: ACGAGTGTCTGGCCAAGGT
AGCCTCCGGCTGCCCTGTT: GCCTCCGGCTGCCCTGTTC
TGCTGACTCCTGGCACAAT: GCTGACTCCTGGCACAATT
TGGAGGATGAACGGATTAT: GGAGGATGAACGGATTATT
GCCGTGATGTAGGAAAAGC: CCGTGATGTAGGAAAAGCG
AGATCCCTCTGCGCATCCT: GATCCCTCTGCGCATCCTA
TTAACACTCCACTGGTCAG: TAACACTCCACTGGTCAGG
CGACACGTAACAGTTGGTG: GACACGTAACAGTTGGTGT
GGAAAAAACTTGGCTTCTA: GAAAAAACTTGGCTTCTAT
TTGGAGCTAGACTATGAGA: TGGAGCTAGACTATGAGAC
CCTCTAGATCCTGTGTACT: CTCTAGATCCTGTGTACTG
GTAAGCACAGGTCCAAACT: TAAGCACAGGTCCAAACTA
AGTTCAAACAGCGTGATGA: GTTCAAACAGCGTGATGAG
TGGAACTGGTAACTTCGAA: GGAACTGGTAACTTCGAAC
GTTTTGAGGACATACCAAC: TTTTGAGGACATACCAACG
TACCTAGCGTTACACTAAA: ACCTAGCGTTACACTAAAG
ACGAGACCGAGCCACGAAC: CGAGACCGAGCCACGAACA
CGCTAGCAAAGATCCAGTC: GCTAGCAAAGATCCAGTCC
TACAAGTAGTTCAATGTAC: ACAAGTAGTTCAATGTACC
AGTGTTCACGCTATCGTAC: GTGTTCACGCTATCGTACC
GAAAGAGGCTTCGGCCGTG: AAAGAGGCTTCGGCCGTGA
ACAGAGGAAGCCGTGTACC: CAGAGGAAGCCGTGTACCT
GTTTGTCACGGACGTAAGC: TTTGTCACGGACGTAAGCT
CAGTACCACCACACTCCGA: AGTACCACCACACTCCGAT
GAAGCCGTGTACCTTCACG: AAGCCGTGTACCTTCACGA
TATCGGGCACACTAAGGCA: ATCGGGCACACTAAGGCAA
CTACAGGCCGCAATCAGGC: TACAGGCCGCAATCAGGCC
CCTTAACGGACCTGCTTGT: CTTAACGGACCTGCTTGTG
TCCGGTGCGTTGCTTAGTT: CCGGTGCGTTGCTTAGTTA
CCCTGTAGGTATCTTTCGG: CCTGTAGGTATCTTTCGGT
GTTGTGCGTCATATACCAA: TTGTGCGTCATATACCAAG
GCGGCTGGGCACTTCGCGG: CGGCTGGGCACTTCGCGGT
TGAACACCGATTTGGTCGA: GAACACCGATTTGGTCGAA
AAATCCGGGAAGTGCGCGT: AATCCGGGAAGTGCGCGTC
GAACCCGATTGCTGCTAGC: AACCCGATTGCTGCTAGCC
GTTCACCTGACTGTACCGC: TTCACCTGACTGTACCGCA
AATGTACCTACGAGACCGA: ATGTACCTACGAGACCGAG
TGGATGTCAATAACCGCTA: GGATGTCAATAACCGCTAC
GGTCCTTGTTCTAGAACGC: GTCCTTGTTCTAGAACGCG
GGACGTAAGCTTGTTCTCG: GACGTAAGCTTGTTCTCGT
ACCGCATGAGAATGGTTCG: CCGCATGAGAATGGTTCGG
GGCACCAACTTGCTTTCGT: GCACCAACTTGCTTTCGTG
CCTACCTAGCGTTACACTA: CTACCTAGCGTTACACTAA
ACTGGTCAGGTCTGCGGTG: CTGGTCAGGTCTGCGGTGA
CTCATTCGTTCGCACAAAA: TCATTCGTTCGCACAAAAT
TCAATGACCTTTCAATATC: CAATGACCTTTCAATATCG
GTATGTCTCACCACGATGA: TATGTCTCACCACGATGAC
GTAGTCATAGTTAGTCAAG: TAGTCATAGTTAGTCAAGC
TAGTGTTCACGCTATCGTA: AGTGTTCACGCTATCGTAC
ATCCACAGGCGTGCGAAGA: TCCACAGGCGTGCGAAGAG
CCACACTCCGATGCACCAT: CACACTCCGATGCACCATA
TTCACGAGCGAGAGGATTT: TCACGAGCGAGAGGATTTA
CGAGGTCCGTTTGAGACTA: GAGGTCCGTTTGAGACTAC
GGTAACTTCGAACCTGGGG: GTAACTTCGAACCTGGGGA
TGATCTAAATCCGGGAAGT: GATCTAAATCCGGGAAGTG
TCATATACCAAGTTTCGCA: CATATACCAAGTTTCGCAC
AGCGTCCGACGACACGTAA: GCGTCCGACGACACGTAAC
GAACGCGGCTGAGGACGAA: AACGCGGCTGAGGACGAAA
TGGCTTCTATCGTTCCCTG: GGCTTCTATCGTTCCCTGC
AGACCGCATGAGAATGGTT: GACCGCATGAGAATGGTTC
TACGAGACCGAGCCACGAA: ACGAGACCGAGCCACGAAC
GGAAAGTTCAAACAGCGTG: GAAAGTTCAAACAGCGTGA
GTCCTTTTCCTTTCTCTAG: TCCTTTTCCTTTCTCTAGT
GAGCGTTTTACTACCTCAT: AGCGTTTTACTACCTCATT
TGGTATGTCTCACCACGAT: GGTATGTCTCACCACGATG
TTTCTGAAAGAGGCTTCGG: TTCTGAAAGAGGCTTCGGC
GCGGCTGAGGACGAAACTG: CGGCTGAGGACGAAACTGC
TAAGGGGTAGCGTCCTTTT: AAGGGGTAGCGTCCTTTTC
CGAGTGTCTGGCCAAGGTC: GAGTGTCTGGCCAAGGTCC
GACTCCTGGCACAATTCGC: ACTCCTGGCACAATTCGCG
CGGGTGGTATACACCGTAG: GGGTGGTATACACCGTAGG
CAAGTTTCGCACCCTTCAA: AAGTTTCGCACCCTTCAAC
CTACAGCTCCATCAAGCCT: TACAGCTCCATCAAGCCTT
ACGTATTTCTCTAGGATAT: CGTATTTCTCTAGGATATA
ACCAATAAGCTTGTGCGGC: CCAATAAGCTTGTGCGGCT
ACGAACACATGCGCTCGAC: CGAACACATGCGCTCGACC
TTCCCTGCAGTGAGGTTTG: TCCCTGCAGTGAGGTTTGA
AAGTAGTTCAATGTACCTA: AGTAGTTCAATGTACCTAC
CTCCACTGGTCAGGTCTGC: TCCACTGGTCAGGTCTGCG
ACAAACTGAGACGACTACA: CAAACTGAGACGACTACAG
GCAGTGAGGTTTGATCGGG: CAGTGAGGTTTGATCGGGT
CGGCAAGGTACATCTCCTG: GGCAAGGTACATCTCCTGG
CGCGAGTAGTCATAGTTAG: GCGAGTAGTCATAGTTAGT
AGACTAGTGTTCACGCTAT: GACTAGTGTTCACGCTATC
TTAGATGACTCAATTGAGC: TAGATGACTCAATTGAGCC
GTTGCTTAGTTAGAACCCG: TTGCTTAGTTAGAACCCGA
TATTTCTCTAGGATATAGC: ATTTCTCTAGGATATAGCC
CACCGATTTGGTCGAACCC: ACCGATTTGGTCGAACCCA
CAAACTAGAGTTGGCACTC: AAACTAGAGTTGGCACTCT
TCGGGTGGTATACACCGTA: CGGGTGGTATACACCGTAG
TAGATCCTGTGTACTGCCG: AGATCCTGTGTACTGCCGA
CGGTTTTGAGGACATACCA: GGTTTTGAGGACATACCAA
ACTGCCAAAAGTGCACGCT: CTGCCAAAAGTGCACGCTG
GTCTCGGTCATCAGCTATC: TCTCGGTCATCAGCTATCA
GTTCGGCAAGGTACATCTC: TTCGGCAAGGTACATCTCC
AGTTAAGTAGAAAGTTGTG: GTTAAGTAGAAAGTTGTGC
CAATTACGGCGCTAGCAAA: AATTACGGCGCTAGCAAAG
GGAAGCCGTGTACCTTCAC: GAAGCCGTGTACCTTCACG
TTTGAGGACATACCAACGG: TTGAGGACATACCAACGGG
TCGGCTCACACGACAATAG: CGGCTCACACGACAATAGA
GGTGTTCGATCTATTGGAG: GTGTTCGATCTATTGGAGT
ATCTTGAACGCTCGAAATT: TCTTGAACGCTCGAAATTT
GCTATCTCAGTGATGCTGG: CTATCTCAGTGATGCTGGA
TCTATTGGAGTCTAGATCT: CTATTGGAGTCTAGATCTC
TTAGTCAAGCCGGTTAGCG: TAGTCAAGCCGGTTAGCGA
AGCCACGAACACATGCGCT: GCCACGAACACATGCGCTC
TTAAACTAGTTAAGTAGAA: TAAACTAGTTAAGTAGAAA
GCTGCTAGCCGAAACGAAC: CTGCTAGCCGAAACGAACC
GCGCGAGTAGTCATAGTTA: CGCGAGTAGTCATAGTTAG
TCAAGCCTTCTTTCACGAT: CAAGCCTTCTTTCACGATT
AAGCGTCGGGTGGTATACA: AGCGTCGGGTGGTATACAC
CTATCGGCTGAATTAAACA: TATCGGCTGAATTAAACAT
CATGCGCTGCAGTACTTCT: ATGCGCTGCAGTACTTCTG
TACCAACGGGCGCGAGTAG: ACCAACGGGCGCGAGTAGT
TCAATGTACCTACGAGACC: CAATGTACCTACGAGACCG
TGGCAGTACCCTACCTAGC: GGCAGTACCCTACCTAGCG
TACTTCTGGATGTCAATAA: ACTTCTGGATGTCAATAAC
TTTCGGTACCAATAAGCTT: TTCGGTACCAATAAGCTTG
TACTAATGCATTAGATGAC: ACTAATGCATTAGATGACT
CGTTCGCACAAAATGCTTA: GTTCGCACAAAATGCTTAA
GGAGGATGAACGGATTATT: GAGGATGAACGGATTATTC
GTTCAATGTACCTACGAGA: TTCAATGTACCTACGAGAC
TATCGTACCTTAACGGACC: ATCGTACCTTAACGGACCT
ATAATCGTCATCCCGTACA: TAATCGTCATCCCGTACAC
AGGACGAAACTGCCAAAAG: GGACGAAACTGCCAAAAGT
CTTGTTCTCGTCTACAGGC: TTGTTCTCGTCTACAGGCC
ATCGGAAAGTTTATTGCCG: TCGGAAAGTTTATTGCCGC
GCACAATTCGCGAGGTCCG: CACAATTCGCGAGGTCCGT
CAACTGGTATGTCTCACCA: AACTGGTATGTCTCACCAC
ATCCTCCTCTATCGGCTGA: TCCTCCTCTATCGGCTGAA
GAGCGTTAAACAACATAAC: AGCGTTAAACAACATAACC
GAAGAGTAGAACGGTAGAT: AAGAGTAGAACGGTAGATG
GCCCCTGCGAAACGTAACA: CCCCTGCGAAACGTAACAG
ACTGACTCAAAGTGTGACA: CTGACTCAAAGTGTGACAG
TAAAGAGCGTTCCAGCGCG: AAAGAGCGTTCCAGCGCGT
CAGCTATTCGGACCGCTTG: AGCTATTCGGACCGCTTGA
TGGGACTAATGAACACCGA: GGGACTAATGAACACCGAT
GGCGTGCGAAGAGTAGAAC: GCGTGCGAAGAGTAGAACG
TCAGGTCTGCGGTGATAGA: CAGGTCTGCGGTGATAGAA
TTTGACTGATCCTTAAGAC: TTGACTGATCCTTAAGACC
TACGCCCCATACATGAGAC: ACGCCCCATACATGAGACT
TGCAGTACTTCTGGATGTC: GCAGTACTTCTGGATGTCA
TCGTGAGGTAGATCCCTCT: CGTGAGGTAGATCCCTCTG
TTGGTCGAACCCAGCTATT: TGGTCGAACCCAGCTATTC
AGTTGGTGTCTCGGTATAT: GTTGGTGTCTCGGTATATC
GAAACTGCCAAAAGTGCAC: AAACTGCCAAAAGTGCACG
AAAGAGCGTTACTGCTGAC: AAGAGCGTTACTGCTGACT
AAGTTGTGCGTCATATACC: AGTTGTGCGTCATATACCA
ACGGACCTGCTTGTGCGGC: CGGACCTGCTTGTGCGGCT
CTTAGTTAGAACCCGATTG: TTAGTTAGAACCCGATTGC
CTCCGAGAGTACTCTTGAT: TCCGAGAGTACTCTTGATC
TGGTAACTTCGAACCTGGG: GGTAACTTCGAACCTGGGG
AAGTTTCTGAAAGAGGCTT: AGTTTCTGAAAGAGGCTTC
GCTCCATCAAGCCTTCTTT: CTCCATCAAGCCTTCTTTC
AAACAGCGTGATGAGACTT: AACAGCGTGATGAGACTTA
CTTGTGCGGCTGGGCACTT: TTGTGCGGCTGGGCACTTC
CTGCCCTGTTCACCTGACT: TGCCCTGTTCACCTGACTG
GACTTAAAGAGCGTTAAAC: ACTTAAAGAGCGTTAAACA
GTAGAACGGTAGATGTTGA: TAGAACGGTAGATGTTGAT
GCTGACTGACTCAAAGTGT: CTGACTGACTCAAAGTGTG
CTCCGATGCACCATATGCT: TCCGATGCACCATATGCTG
AGGCAATTACGGCGCTAGC: GGCAATTACGGCGCTAGCA
GGATATAGCCCCTGCGAAA: GATATAGCCCCTGCGAAAC
CGTGCCACACTGACCCAGA: GTGCCACACTGACCCAGAC
GGGCAGTCTCGATTCTCCG: GGCAGTCTCGATTCTCCGA
TCCTTAAGACCGTCCTGTG: CCTTAAGACCGTCCTGTGC
GCGTTTTCCAAGCGTCGGG: CGTTTTCCAAGCGTCGGGT
CACCAACTTGCTTTCGTGA: ACCAACTTGCTTTCGTGAG
GGATTATTCGCCTACGATC: GATTATTCGCCTACGATCA
TTTCTCTAGTGGGTAGTCA: TTCTCTAGTGGGTAGTCAG
AACCGCTACTCGATTCAAG: ACCGCTACTCGATTCAAGG
AAAGAGCGTTCCAGCGCGT: AAGAGCGTTCCAGCGCGTT
AGAGTAGAACGGTAGATGT: GAGTAGAACGGTAGATGTT
TTCTTTCACGATTTACGGT: TCTTTCACGATTTACGGTC
TGTCTCACCACGATGACGG: GTCTCACCACGATGACGGA
TGCCGCCGATGAGACTTAA: GCCGCCGATGAGACTTAAA
GAGCCACGAACACATGCGC: AGCCACGAACACATGCGCT
TTCGCGAGGTCCGTTTGAG: TCGCGAGGTCCGTTTGAGA
ACCCAGACTGATAATCGTC: CCCAGACTGATAATCGTCA
AGCACAGGTCCAAACTAGA: GCACAGGTCCAAACTAGAG
ATTACGCATCCTCCGGTTT: TTACGCATCCTCCGGTTTT
TGTACCTACGAGACCGAGC: GTACCTACGAGACCGAGCC
CGGCTGCCCTGTTCACCTG: GGCTGCCCTGTTCACCTGA
CGGTATAGAGGAGAACGAT: GGTATAGAGGAGAACGATC
CTCGCACAGCAAAGTTTTG: TCGCACAGCAAAGTTTTGA
TCCTTGTTCTAGAACGCGG: CCTTGTTCTAGAACGCGGC
ACGCTGGTCGGCTCACACG: CGCTGGTCGGCTCACACGA
TCCTCCTCTATCGGCTGAA: CCTCCTCTATCGGCTGAAT
GAGACTTAAAGAGCGTTAC: AGACTTAAAGAGCGTTACT
AGTCAGTACCACCACACTC: GTCAGTACCACCACACTCC
GGTTAGCGAAGTTTCTGAA: GTTAGCGAAGTTTCTGAAA
GCTGTTCACCACTAGCGCA: CTGTTCACCACTAGCGCAT
CATGAGAATGGTTCGGCAA: ATGAGAATGGTTCGGCAAG
CCACACTGACCCAGACTGA: CACACTGACCCAGACTGAT
GTGTTCACGCTATCGTACC: TGTTCACGCTATCGTACCT
AGGCTTAAACTAGTTAAGT: GGCTTAAACTAGTTAAGTA
CACGATTTACGGTCCTCTA: ACGATTTACGGTCCTCTAG
TGCATTAGATGACTCAATT: GCATTAGATGACTCAATTG
GGATGTCAATAACCGCTAC: GATGTCAATAACCGCTACT
CACACGACAATAGAACTCT: ACACGACAATAGAACTCTT
TAAACATGCGCTGCAGTAC: AAACATGCGCTGCAGTACT
AAGTTTATTGCCGCCGATG: AGTTTATTGCCGCCGATGA
CCTGGTCAACTGGTATGTC: CTGGTCAACTGGTATGTCT
ATGACGGAAGCCTCCTGAT: TGACGGAAGCCTCCTGATC
CCGGTGCGTTGCTTAGTTA: CGGTGCGTTGCTTAGTTAG
CTGGGGAGACGCTGGTCGG: TGGGGAGACGCTGGTCGGC
TTGACACACCGACAAACTG: TGACACACCGACAAACTGA
CCTGTGCTGACTGACTCAA: CTGTGCTGACTGACTCAAA
TATTCGGACCGCTTGACAC: ATTCGGACCGCTTGACACA
AACTGCCAAAAGTGCACGC: ACTGCCAAAAGTGCACGCT
AAGCCACGAGGAAAAAACT: AGCCACGAGGAAAAAACTT
GACAGAGGAAGCCGTGTAC: ACAGAGGAAGCCGTGTACC
GTGGCAGTACCCTACCTAG: TGGCAGTACCCTACCTAGC
CAAGTTAGACTAGTGTTCA: AAGTTAGACTAGTGTTCAC
GCGTTTTACTACCTCATTC: CGTTTTACTACCTCATTCG
TAGAAGCCACGAGGAAAAA: AGAAGCCACGAGGAAAAAA
CAGTCTCGATTCTCCGAGA: AGTCTCGATTCTCCGAGAG
TCAGCGGTGTTCGATCTAT: CAGCGGTGTTCGATCTATT
CCAGCCTCCGGCTGCCCTG: CAGCCTCCGGCTGCCCTGT
ATAGAGGAGAACGATCTTG: TAGAGGAGAACGATCTTGA
CTTGACACACCGACAAACT: TTGACACACCGACAAACTG
GCGAAGAGTAGAACGGTAG: CGAAGAGTAGAACGGTAGA
ATGCATTAGATGACTCAAT: TGCATTAGATGACTCAATT
TCCTTTCTCTAGTGGGTAG: CCTTTCTCTAGTGGGTAGT
AGGTATCTTTCGGTACCAA: GGTATCTTTCGGTACCAAT
AGAACGCGGCTGAGGACGA: GAACGCGGCTGAGGACGAA
CTGCTGACTCCTGGCACAA: TGCTGACTCCTGGCACAAT
ACCCTTCAACTCTACATTA: CCCTTCAACTCTACATTAC
AGTGGGTAGTCAGTACCAC: GTGGGTAGTCAGTACCACC
TGGTGTCTCGGTATATCGC: GGTGTCTCGGTATATCGCA
TGCTCAGCGTGCCACACTG: GCTCAGCGTGCCACACTGA
GAGTACTCTTGATCGGAAA: AGTACTCTTGATCGGAAAG
CGCGGCTGAGGACGAAACT: GCGGCTGAGGACGAAACTG
ATCTCCGCTGAAACGGTAT: TCTCCGCTGAAACGGTATA
GGAGACGCTGGTCGGCTCA: GAGACGCTGGTCGGCTCAC
CATCTCCTGGAACTGGTAA: ATCTCCTGGAACTGGTAAC
AAGAGCGTTCCAGCGCGTT: AGAGCGTTCCAGCGCGTTT
TCACGGACGTAAGCTTGTT: CACGGACGTAAGCTTGTTC
GCGTTCCAGCGCGTTTTCC: CGTTCCAGCGCGTTTTCCA
ACTCAATTGAGCCGTGATG: CTCAATTGAGCCGTGATGT
TGGCACCAACTTGCTTTCG: GGCACCAACTTGCTTTCGT
ACAGGCGTGCGAAGAGTAG: CAGGCGTGCGAAGAGTAGA
GTATCTTTCGGTACCAATA: TATCTTTCGGTACCAATAA
CCCGTACACGTATTTCTCT: CCGTACACGTATTTCTCTA
CGGTTAGCGAAGTTTCTGA: GGTTAGCGAAGTTTCTGAA
TCTGAAAGAGGCTTCGGCC: CTGAAAGAGGCTTCGGCCG
GATGTCAATAACCGCTACT: ATGTCAATAACCGCTACTC
CCGGTTAGCGAAGTTTCTG: CGGTTAGCGAAGTTTCTGA
GATCCACAGGCGTGCGAAG: ATCCACAGGCGTGCGAAGA
ACAATTCGCGAGGTCCGTT: CAATTCGCGAGGTCCGTTT
ACTGAGACGACTACAGCTC: CTGAGACGACTACAGCTCC
TCCGTTTGAGACTACTAAT: CCGTTTGAGACTACTAATG
TACCGCATCACCACTGCTC: ACCGCATCACCACTGCTCA
GATGCTGGAGCGCCTGGTC: ATGCTGGAGCGCCTGGTCA
TTTCACGATTTACGGTCCT: TTCACGATTTACGGTCCTC
CCAGCGCGTTTTCCAAGCG: CAGCGCGTTTTCCAAGCGT
AACCGTTTTGCCTGGAGGA: ACCGTTTTGCCTGGAGGAT
GCTGCGTAAGACTCTTGAT: CTGCGTAAGACTCTTGATC
CAGGTCCAAACTAGAGTTG: AGGTCCAAACTAGAGTTGG
TGACTCAAAGTGTGACAGA: GACTCAAAGTGTGACAGAG
ACGATTTACGGTCCTCTAG: CGATTTACGGTCCTCTAGA
ACGGGCGCGAGTAGTCATA: CGGGCGCGAGTAGTCATAG
TTCGTTCGCACAAAATGCT: TCGTTCGCACAAAATGCTT
GATCGGGTCTGTCTCGCTA: ATCGGGTCTGTCTCGCTAT
TGCATAGCTCTATGCTTCG: GCATAGCTCTATGCTTCGT
TAAGACTCTTGATCGGAAA: AAGACTCTTGATCGGAAAG
CCTCCTCTATCGGCTGAAT: CTCCTCTATCGGCTGAATT
AGCCCCTGCGAAACGTAAC: GCCCCTGCGAAACGTAACA
AGGTTATTTGGAAAGGGCA: GGTTATTTGGAAAGGGCAG
TGGAGTCTAGATCTCCGCT: GGAGTCTAGATCTCCGCTG
CGCGTCCGGTGCGTTGCTT: GCGTCCGGTGCGTTGCTTA
AGTTACGCCCCATACATGA: GTTACGCCCCATACATGAG
AGGATGAACGGATTATTCG: GGATGAACGGATTATTCGC
CTCTAGATCCTGTGTACTG: TCTAGATCCTGTGTACTGC
GTGTCTGGCCAAGGTCCTT: TGTCTGGCCAAGGTCCTTG
CTAGCGTTACACTAAAGTC: TAGCGTTACACTAAAGTCA
GTATAGAGGAGAACGATCT: TATAGAGGAGAACGATCTT
AAAAACTTGGCTTCTATCG: AAAACTTGGCTTCTATCGT
TGTACCTTCACGAGCGAGA: GTACCTTCACGAGCGAGAG
CACACTCCGATGCACCATA: ACACTCCGATGCACCATAT
TTAAAGAGCGTTTTACTAC: TAAAGAGCGTTTTACTACC
ACCAACTTGCTTTCGTGAG: CCAACTTGCTTTCGTGAGG
CGATCAGTTTGTCACGGAC: GATCAGTTTGTCACGGACG
AAAGATCCAGTCCCTTGAC: AAGATCCAGTCCCTTGACA
GCGTTAAACAACATAACCG: CGTTAAACAACATAACCGT
ATTCTCCGAGAGTACTCTT: TTCTCCGAGAGTACTCTTG
TTTTGAGGACATACCAACG: TTTGAGGACATACCAACGG
TTTTCCAAGCGTCGGGTGG: TTTCCAAGCGTCGGGTGGT
TTTTGACTGATCCTTAAGA: TTTGACTGATCCTTAAGAC
TCGGAAAGTTACGCCCCAT: CGGAAAGTTACGCCCCATA
TGATTAACACTCCACTGGT: GATTAACACTCCACTGGTC
ATCTATTGGAGTCTAGATC: TCTATTGGAGTCTAGATCT
GAAGTGCGCGTCCGGTGCG: AAGTGCGCGTCCGGTGCGT
GCGAAACGTAACAGCACGC: CGAAACGTAACAGCACGCC
GTCAATAACCGCTACTCGA: TCAATAACCGCTACTCGAT
AACACATGCGCTCGACCTC: ACACATGCGCTCGACCTCC
AAGCCGTGTACCTTCACGA: AGCCGTGTACCTTCACGAG
CGAACACATGCGCTCGACC: GAACACATGCGCTCGACCT
CTCAATTGAGCCGTGATGT: TCAATTGAGCCGTGATGTA
TTCACGCTATCGTACCTTA: TCACGCTATCGTACCTTAA
CGCTCGAAATTTGTGAGAC: GCTCGAAATTTGTGAGACA
ACCACCACACTCCGATGCA: CCACCACACTCCGATGCAC
CTAAGGCAATTACGGCGCT: TAAGGCAATTACGGCGCTA
TGTGGCAGTACCCTACCTA: GTGGCAGTACCCTACCTAG
GGGTTTCAATGACCTTTCA: GGTTTCAATGACCTTTCAA
GCGCATTGCATAGCTCTAT: CGCATTGCATAGCTCTATG
CTCGCTATCTCAGTGATGC: TCGCTATCTCAGTGATGCT
CGTGCGAAGAGTAGAACGG: GTGCGAAGAGTAGAACGGT
GACGTAAGCACAGGTCCAA: ACGTAAGCACAGGTCCAAA
CTCAGCGTGCCACACTGAC: TCAGCGTGCCACACTGACC
CTATCTCAGTGATGCTGGA: TATCTCAGTGATGCTGGAG
TTTGAGACTACTAATGCAT: TTGAGACTACTAATGCATT
ATAACCGCTACTCGATTCA: TAACCGCTACTCGATTCAA
TACCCTACCTAGCGTTACA: ACCCTACCTAGCGTTACAC
TCGCCTACGATCAGTTTGT: CGCCTACGATCAGTTTGTC
TGACCTTTCAATATCGTCT: GACCTTTCAATATCGTCTT
TTGTTCTAGAACGCGGCTG: TGTTCTAGAACGCGGCTGA
TTGAGCCGTGATGTAGGAA: TGAGCCGTGATGTAGGAAA
GTCTCGCTATCTCAGTGAT: TCTCGCTATCTCAGTGATG
TTTCGCTGTCGCGTGGTGA: TTCGCTGTCGCGTGGTGAC
CTTGTTCTAGAACGCGGCT: TTGTTCTAGAACGCGGCTG
TATCGCAAAGAGACCGCAT: ATCGCAAAGAGACCGCATG
CAATCAGGCCTCGCACAGC: AATCAGGCCTCGCACAGCA
ATACAAGTAGTTCAATGTA: TACAAGTAGTTCAATGTAC
CTACCTCATTCGTTCGCAC: TACCTCATTCGTTCGCACA
TAGGAAAAGCGTCCGACGA: AGGAAAAGCGTCCGACGAC
CGAGCGAGAGGATTTACTC: GAGCGAGAGGATTTACTCA
AGCCGAAACGAACCCGGCC: GCCGAAACGAACCCGGCCT
GGACCGCTTGACACACCGA: GACCGCTTGACACACCGAC
AGGAAAAAACTTGGCTTCT: GGAAAAAACTTGGCTTCTA
AGAGGCTTCGGCCGTGATC: GAGGCTTCGGCCGTGATCC
TAATGAACACCGATTTGGT: AATGAACACCGATTTGGTC
GAGGTCCGTTTGAGACTAC: AGGTCCGTTTGAGACTACT
GTGATCCACAGGCGTGCGA: TGATCCACAGGCGTGCGAA
CTCACACGACAATAGAACT: TCACACGACAATAGAACTC
GATGAGACTTAAAGAGCGT: ATGAGACTTAAAGAGCGTT ATGAGACTTAAAGAGCGTT
CACGAGGAAAAAACTTGGC: ACGAGGAAAAAACTTGGCT
TCTAGATCCTGTGTACTGC: CTAGATCCTGTGTACTGCC
AATATCGTCTTTCGCTGTC: ATATCGTCTTTCGCTGTCG
CTGCGTAAGACTCTTGATC: TGCGTAAGACTCTTGATCG
ATTGCCGCCGATGAGACTT: TTGCCGCCGATGAGACTTA
GCGCCTGGTCAACTGGTAT: CGCCTGGTCAACTGGTATG
AGCAAAGATCCAGTCCCTT: GCAAAGATCCAGTCCCTTG
CTTTCGGTACCAATAAGCT: TTTCGGTACCAATAAGCTT
CATAACCGTTTTGCCTGGA: ATAACCGTTTTGCCTGGAG
GAGGAAAAAACTTGGCTTC: AGGAAAAAACTTGGCTTCT
CTGATCTAAATCCGGGAAG: TGATCTAAATCCGGGAAGT
CGGCTGAATTAAACATGCG: GGCTGAATTAAACATGCGC
TAGACTATGAGACTTAAAG: AGACTATGAGACTTAAAGA
GCTTGACACACCGACAAAC: CTTGACACACCGACAAACT
AGGACGAGTGTCTGGCCAA: GGACGAGTGTCTGGCCAAG
TCCAGCCTCCGGCTGCCCT: CCAGCCTCCGGCTGCCCTG
TCGACCTCCCTGTAGGTAT: CGACCTCCCTGTAGGTATC
TCTCGGTATATCGCAAAGA: CTCGGTATATCGCAAAGAG
AAACTTGGCTTCTATCGTT: AACTTGGCTTCTATCGTTC
GCGCTGCAGTACTTCTGGA: CGCTGCAGTACTTCTGGAT
CCACTAGCGCATTGCATAG: CACTAGCGCATTGCATAGC
ATAGAAGCCACGAGGAAAA: TAGAAGCCACGAGGAAAAA
ACGAACCCGGCCTGGCACC: CGAACCCGGCCTGGCACCA
TGCCGAAGGGTTTCAATGA: GCCGAAGGGTTTCAATGAC
CTTCTGGATGTCAATAACC: TTCTGGATGTCAATAACCG
GTCTAGATCTCCGCTGAAA: TCTAGATCTCCGCTGAAAC
ATAGTTAGTCAAGCCGGTT: TAGTTAGTCAAGCCGGTTA
CCTCGCACAGCAAAGTTTT: CTCGCACAGCAAAGTTTTG
AGTTTCGCACCCTTCAACT: GTTTCGCACCCTTCAACTC
CAACATAACCGTTTTGCCT: AACATAACCGTTTTGCCTG
AAGAGCGTTTTACTACCTC: AGAGCGTTTTACTACCTCA
AGTAGTTCAATGTACCTAC: GTAGTTCAATGTACCTACG
AAATGCTTAAGGGGTAGCG: AATGCTTAAGGGGTAGCGT
CCGATACAAGTAGTTCAAT: CGATACAAGTAGTTCAATG
AAGCCTTCTTTCACGATTT: AGCCTTCTTTCACGATTTA
CGGTATATCGCAAAGAGAC: GGTATATCGCAAAGAGACC
TGAGACTTAAAGAGCGTTT: GAGACTTAAAGAGCGTTTT
CACAATTCGCGAGGTCCGT: ACAATTCGCGAGGTCCGTT
TAACCGTTTTGCCTGGAGG: AACCGTTTTGCCTGGAGGA
ATGGTTCGGCAAGGTACAT: TGGTTCGGCAAGGTACATC
TCCAGCGCGTTTTCCAAGC: CCAGCGCGTTTTCCAAGCG
ATCGGGTCTGTCTCGCTAT: TCGGGTCTGTCTCGCTATC
ACTTGGCTTCTATCGTTCC: CTTGGCTTCTATCGTTCCC
ATTAACACTCCACTGGTCA: TTAACACTCCACTGGTCAG
TAAGCACAGGTCCAAACTA: AAGCACAGGTCCAAACTAG
TCCAAACTAGAGTTGGCAC: CCAAACTAGAGTTGGCACT
AGCGTTAAACAACATAACC: GCGTTAAACAACATAACCG
ACTAGTGTTCACGCTATCG: CTAGTGTTCACGCTATCGT
CACCGTAGGCTTAAACTAG: ACCGTAGGCTTAAACTAGT
CCACCACACTCCGATGCAC: CACCACACTCCGATGCACC
CGCTGGTCGGCTCACACGA: GCTGGTCGGCTCACACGAC
GCCGCCGATGAGACTTAAA: CCGCCGATGAGACTTAAAG
TTTCAATATCGTCTTTCGC: TTCAATATCGTCTTTCGCT
CGGTATATCGGGCACACTA: GGTATATCGGGCACACTAA
ATCCCGTACACGTATTTCT: TCCCGTACACGTATTTCTC
ACCACGATGACGGAAGCCT: CCACGATGACGGAAGCCTC
CCTAGATCATGCCGAAGGG: CTAGATCATGCCGAAGGGT
CGCCCCATACATGAGACTT: GCCCCATACATGAGACTTA
ATACCAACGGGCGCGAGTA: TACCAACGGGCGCGAGTAG
CGTAAGACTCTTGATCGGA: GTAAGACTCTTGATCGGAA
GGTGACAGGACGAGTGTCT: GTGACAGGACGAGTGTCTG
GTCATAGTTAGTCAAGCCG: TCATAGTTAGTCAAGCCGG
GTTCCAGCGCGTTTTCCAA: TTCCAGCGCGTTTTCCAAG
CTATCACGGGTGGGACTAA: TATCACGGGTGGGACTAAT
TACACCGTAGGCTTAAACT: ACACCGTAGGCTTAAACTA
TGTTCACGCTATCGTACCT: GTTCACGCTATCGTACCTT
TGAGGTTTGATCGGGTCTG: GAGGTTTGATCGGGTCTGT
AACGAACCCGGCCTGGCAC: ACGAACCCGGCCTGGCACC
GCTCGAAATTTGTGAGACA: CTCGAAATTTGTGAGACAT
TTAGACTAGTGTTCACGCT: TAGACTAGTGTTCACGCTA
ATACCAAGTTTCGCACCCT: TACCAAGTTTCGCACCCTT
AGATGTTGATTAACACTCC: GATGTTGATTAACACTCCA
CGAGAGTACTCTTGATCGG: GAGAGTACTCTTGATCGGA
CGAGCCACGAACACATGCG: GAGCCACGAACACATGCGC
AGAGCGTTACTGCTGACTC: GAGCGTTACTGCTGACTCC
GCGAAGTTTCTGAAAGAGG: CGAAGTTTCTGAAAGAGGC
ATCAGTTTGTCACGGACGT: TCAGTTTGTCACGGACGTA
CGACTACAGCTCCATCAAG: GACTACAGCTCCATCAAGC
GTTTGAGACTACTAATGCA: TTTGAGACTACTAATGCAT
AGGTTTGATCGGGTCTGTC: GGTTTGATCGGGTCTGTCT
GTTCTAGAACGCGGCTGAG: TTCTAGAACGCGGCTGAGG
GTTTCAATGACCTTTCAAT: TTTCAATGACCTTTCAATA
ATAGCCCCTGCGAAACGTA: TAGCCCCTGCGAAACGTAA
GGCTGAGGACGAAACTGCC: GCTGAGGACGAAACTGCCA
CGGGCGCGAGTAGTCATAG: GGGCGCGAGTAGTCATAGT
CCGTGATGTAGGAAAAGCG: CGTGATGTAGGAAAAGCGT
CACGCTGTGTGGCAGTACC: ACGCTGTGTGGCAGTACCC
ATCCTAGATCATGCCGAAG: TCCTAGATCATGCCGAAGG
CGATTTGGTCGAACCCAGC: GATTTGGTCGAACCCAGCT
TGCGGTGATAGAAGCCACG: GCGGTGATAGAAGCCACGA
ACGATGACGGAAGCCTCCT: CGATGACGGAAGCCTCCTG
GCGCTAGCAAAGATCCAGT: CGCTAGCAAAGATCCAGTC
GACAATAGAACTCTTGATC: ACAATAGAACTCTTGATCG
GCATCACCACTGCTCAGCG: CATCACCACTGCTCAGCGT
AGTCCCTTGACACTAGACG: GTCCCTTGACACTAGACGT
GCGGTGTTCGATCTATTGG: CGGTGTTCGATCTATTGGA
CACGTATTTCTCTAGGATA: ACGTATTTCTCTAGGATAT
TCGGAAAGTTGGAGCTAGA: CGGAAAGTTGGAGCTAGAC
AGTTAGAACCCGATTGCTG: GTTAGAACCCGATTGCTGC
ACTACTAATGCATTAGATG: CTACTAATGCATTAGATGA
ACATGAGACTTAAAGAGCG: CATGAGACTTAAAGAGCGT
AAAATGCTTAAGGGGTAGC: AAATGCTTAAGGGGTAGCG
ACTGCCGATACAAGTAGTT: CTGCCGATACAAGTAGTTC
TGCTTAAGGGGTAGCGTCC: GCTTAAGGGGTAGCGTCCT
GTTACTGCTGACTCCTGGC: TTACTGCTGACTCCTGGCA
ATTTACGGTCCTCTAGATC: TTTACGGTCCTCTAGATCC
GGCCTCGCACAGCAAAGTT: GCCTCGCACAGCAAAGTTT
GGGCGCGAGTAGTCATAGT: GGCGCGAGTAGTCATAGTT
TTGCTGCTAGCCGAAACGA: TGCTGCTAGCCGAAACGAA
TAGTCATAGTTAGTCAAGC: AGTCATAGTTAGTCAAGCC
GTATATCGCAAAGAGACCG: TATATCGCAAAGAGACCGC
ACTAAGGCAATTACGGCGC: CTAAGGCAATTACGGCGCT
AGATCTCCGCTGAAACGGT: GATCTCCGCTGAAACGGTA
TCCGGGAAGTGCGCGTCCG: CCGGGAAGTGCGCGTCCGG
TTGATTAACACTCCACTGG: TGATTAACACTCCACTGGT
TTGTCACGGACGTAAGCTT: TGTCACGGACGTAAGCTTG
AGACGACTACAGCTCCATC: GACGACTACAGCTCCATCA
GTAGTCAGTACCACCACAC: TAGTCAGTACCACCACACT
TTTACTACCTCATTCGTTC: TTACTACCTCATTCGTTCG
GTCATCCCGTACACGTATT: TCATCCCGTACACGTATTT
TGATCGGAAAGTTTATTGC: GATCGGAAAGTTTATTGCC
GTCCGGTGCGTTGCTTAGT: TCCGGTGCGTTGCTTAGTT
GTGTACTGCCGATACAAGT: TGTACTGCCGATACAAGTA
CACAGCAAAGTTTTGACTG: ACAGCAAAGTTTTGACTGA
ATTGCATAGCTCTATGCTT: TTGCATAGCTCTATGCTTC
ACGGCGCTAGCAAAGATCC: CGGCGCTAGCAAAGATCCA
GAACGGTAGATGTTGATTA: AACGGTAGATGTTGATTAA
ACCAAGTTTCGCACCCTTC: CCAAGTTTCGCACCCTTCA
GAGGAAGCCGTGTACCTTC: AGGAAGCCGTGTACCTTCA
AAAAGTGCACGCTGTGTGG: AAAGTGCACGCTGTGTGGC
AGAACTCTTGATCGGAAAG: GAACTCTTGATCGGAAAGT
TCTCGCTATCTCAGTGATG: CTCGCTATCTCAGTGATGC
GCGTCATATACCAAGTTTC: CGTCATATACCAAGTTTCG
GAAGTTTCTGAAAGAGGCT: AAGTTTCTGAAAGAGGCTT
ATAACCGTTTTGCCTGGAG: TAACCGTTTTGCCTGGAGG
AACGGTATATCGGGCACAC: ACGGTATATCGGGCACACT
ACTGGTAACTTCGAACCTG: CTGGTAACTTCGAACCTGG
GCATTAGATGACTCAATTG: CATTAGATGACTCAATTGA
GTAACTTCGAACCTGGGGA: TAACTTCGAACCTGGGGAG
TTGGCACTCTTGATCGGAA: TGGCACTCTTGATCGGAAA
ACGCTATCGTACCTTAACG: CGCTATCGTACCTTAACGG
TATGTCTCACCACGATGAC: ATGTCTCACCACGATGACG
CCACTGGTCAGGTCTGCGG: CACTGGTCAGGTCTGCGGT
CCGAAACGAACCCGGCCTG: CGAAACGAACCCGGCCTGG
CCTAGCGTTACACTAAAGT: CTAGCGTTACACTAAAGTC
GCCTGGAGGATGAACGGAT: CCTGGAGGATGAACGGATT
ATGCTGGAGCGCCTGGTCA: TGCTGGAGCGCCTGGTCAA
CCTGGCACAATTCGCGAGG: CTGGCACAATTCGCGAGGT
TCCCTTGACACTAGACGTA: CCCTTGACACTAGACGTAA
AGTTAGACTAGTGTTCACG: GTTAGACTAGTGTTCACGC
CCCAGACTGATAATCGTCA: CCAGACTGATAATCGTCAT
TCTTGATCGGAAAGTTTAT: CTTGATCGGAAAGTTTATT
GGCGCGAGTAGTCATAGTT: GCGCGAGTAGTCATAGTTA
CATCCTCCGGTTTTGAGGA: ATCCTCCGGTTTTGAGGAC
TGGAAAGGGCAGTCTCGAT: GGAAAGGGCAGTCTCGATT
ATCACCACTGCTCAGCGTG: TCACCACTGCTCAGCGTGC
GCGTCCTTTTCCTTTCTCT: CGTCCTTTTCCTTTCTCTA
TCTTGATCGGAAAGTTACG: CTTGATCGGAAAGTTACGC
ACGGTATAGAGGAGAACGA: CGGTATAGAGGAGAACGAT
CAAGGTACATCTCCTGGAA: AAGGTACATCTCCTGGAAC
TGACAGGACGAGTGTCTGG: GACAGGACGAGTGTCTGGC
TCAGTACCACCACACTCCG: CAGTACCACCACACTCCGA
AGCTTGTGCGGCTGCGTAA: GCTTGTGCGGCTGCGTAAG
GACTAATGAACACCGATTT: ACTAATGAACACCGATTTG
AAGCGTCCGACGACACGTA: AGCGTCCGACGACACGTAA
GCGAGGTCCGTTTGAGACT: CGAGGTCCGTTTGAGACTA
ATACATGAGACTTAAAGAG: TACATGAGACTTAAAGAGC
AGACTATGAGACTTAAAGA: GACTATGAGACTTAAAGAG
TCAAGGTTATTTGGAAAGG: CAAGGTTATTTGGAAAGGG
AACTCTTGATCGGAAAGTT: ACTCTTGATCGGAAAGTTA
TAGAACTCTTGATCGGAAA: AGAACTCTTGATCGGAAAG
AGCCGTGATGTAGGAAAAG: GCCGTGATGTAGGAAAAGC
TGCTTGTGCGGCTGGGCAC: GCTTGTGCGGCTGGGCACT
AACGATCTTGAACGCTCGA: ACGATCTTGAACGCTCGAA
GCCGGTTAGCGAAGTTTCT: CCGGTTAGCGAAGTTTCTG
ACATCCTCCTCTATCGGCT: CATCCTCCTCTATCGGCTG
GTAGATCCCTCTGCGCATC: TAGATCCCTCTGCGCATCC
TTTACTCAGCGGTGTTCGA: TTACTCAGCGGTGTTCGAT
GAAACGAACCCGGCCTGGC: AAACGAACCCGGCCTGGCA
CACTCCGATGCACCATATG: ACTCCGATGCACCATATGC
TAGTTAGAACCCGATTGCT: AGTTAGAACCCGATTGCTG
ACGGTATATCGGGCACACT: CGGTATATCGGGCACACTA
TCGTCATCCCGTACACGTA: CGTCATCCCGTACACGTAT
CCTGCGAAACGTAACAGCA: CTGCGAAACGTAACAGCAC
ATGAACACCGATTTGGTCG: TGAACACCGATTTGGTCGA
ATCATGCCGAAGGGTTTCA: TCATGCCGAAGGGTTTCAA
GACGACACGTAACAGTTGG: ACGACACGTAACAGTTGGT
GTATTTCTCTAGGATATAG: TATTTCTCTAGGATATAGC
GGCACTCTTGATCGGAAAG: GCACTCTTGATCGGAAAGT
TCGCACCCTTCAACTCTAC: CGCACCCTTCAACTCTACA
AACGGGCGCGAGTAGTCAT: ACGGGCGCGAGTAGTCATA
TCGAAATTTGTGAGACATC: CGAAATTTGTGAGACATCC
GTTAGCGAAGTTTCTGAAA: TTAGCGAAGTTTCTGAAAG
GTAGGCTTAAACTAGTTAA: TAGGCTTAAACTAGTTAAG
TCCTTTTCCTTTCTCTAGT: CCTTTTCCTTTCTCTAGTG
GATCTCCGCTGAAACGGTA: ATCTCCGCTGAAACGGTAT
GGTAGATGTTGATTAACAC: GTAGATGTTGATTAACACT
GACCGTCCTGTGCTGACTG: ACCGTCCTGTGCTGACTGA
CCATACATGAGACTTAAAG: CATACATGAGACTTAAAGA
ACATGCGCTCGACCTCCCT: CATGCGCTCGACCTCCCTG
CTAGTTAAGTAGAAAGTTG: TAGTTAAGTAGAAAGTTGT
ATCCTTAAGACCGTCCTGT: TCCTTAAGACCGTCCTGTG
AGTAGAAAGTTGTGCGTCA: GTAGAAAGTTGTGCGTCAT
CCTTGTTCTAGAACGCGGC: CTTGTTCTAGAACGCGGCT
CTGAAACGGTATATCGGGC: TGAAACGGTATATCGGGCA
ACTTCTGGATGTCAATAAC: CTTCTGGATGTCAATAACC
TTATTGCCGCCGATGAGAC: TATTGCCGCCGATGAGACT
GACTAGTGTTCACGCTATC: ACTAGTGTTCACGCTATCG
CGCTATCTCAGTGATGCTG: GCTATCTCAGTGATGCTGG
ACCTGGGGAGACGCTGGTC: CCTGGGGAGACGCTGGTCG
ATCGGAAAGTTACGCCCCA: TCGGAAAGTTACGCCCCAT
GGCCGCAATCAGGCCTCGC: GCCGCAATCAGGCCTCGCA
CTCGAAATTTGTGAGACAT: TCGAAATTTGTGAGACATC
GAGACCGCATGAGAATGGT: AGACCGCATGAGAATGGTT
AAGTTACGCCCCATACATG: AGTTACGCCCCATACATGA
TGTAGGTATCTTTCGGTAC: GTAGGTATCTTTCGGTACC
CGATTCAAGGTTATTTGGA: GATTCAAGGTTATTTGGAA
TACTACCTCATTCGTTCGC: ACTACCTCATTCGTTCGCA
ACGAGCGAGAGGATTTACT: CGAGCGAGAGGATTTACTC
CACGGTATAGAGGAGAACG: ACGGTATAGAGGAGAACGA
CACGAACACATGCGCTCGA: ACGAACACATGCGCTCGAC
CAGTACTTCTGGATGTCAA: AGTACTTCTGGATGTCAAT
ACCGTCCTGTGCTGACTGA: CCGTCCTGTGCTGACTGAC
TATAGAGGAGAACGATCTT: ATAGAGGAGAACGATCTTG
CTTGTGCGGCTGCGTAAGA: TTGTGCGGCTGCGTAAGAC
GGTCGAACCCAGCTATTCG: GTCGAACCCAGCTATTCGG
CATTGCATAGCTCTATGCT: ATTGCATAGCTCTATGCTT
GAAGCCTCCTGATCTAAAT: AAGCCTCCTGATCTAAATC
GATCTATTGGAGTCTAGAT: ATCTATTGGAGTCTAGATC
AGCTATTCGGACCGCTTGA: GCTATTCGGACCGCTTGAC
GCCTACGATCAGTTTGTCA: CCTACGATCAGTTTGTCAC
TCAGTTTGTCACGGACGTA: CAGTTTGTCACGGACGTAA
AGAGGAGAACGATCTTGAA: GAGGAGAACGATCTTGAAC
CGTAAGCACAGGTCCAAAC: GTAAGCACAGGTCCAAACT
ACACGACAATAGAACTCTT: CACGACAATAGAACTCTTG
CGGGCACACTAAGGCAATT: GGGCACACTAAGGCAATTA
ATGTACCTACGAGACCGAG: TGTACCTACGAGACCGAGC
GCTGTCGCGTGGTGACAGG: CTGTCGCGTGGTGACAGGA
CCGGTTTTGAGGACATACC: CGGTTTTGAGGACATACCA
GTACACGTATTTCTCTAGG: TACACGTATTTCTCTAGGA
CTGCAGTACTTCTGGATGT: TGCAGTACTTCTGGATGTC
GATGACTCAATTGAGCCGT: ATGACTCAATTGAGCCGTG
CAAGTAGTTCAATGTACCT: AAGTAGTTCAATGTACCTA
CTCCTGATCTAAATCCGGG: TCCTGATCTAAATCCGGGA
GAAACGGTATATCGGGCAC: AAACGGTATATCGGGCACA
AGGAGAACGATCTTGAACG: GGAGAACGATCTTGAACGC
ACGCCCCATACATGAGACT: CGCCCCATACATGAGACTT
GGGAGACGCTGGTCGGCTC: GGAGACGCTGGTCGGCTCA
CGGACCTGCTTGTGCGGCT: GGACCTGCTTGTGCGGCTG
GCGTGATGAGACTTAAAGA: CGTGATGAGACTTAAAGAG
CTCAAAGTGTGACAGAGGA: TCAAAGTGTGACAGAGGAA
GACTGACTCAAAGTGTGAC: ACTGACTCAAAGTGTGACA
AATGAACACCGATTTGGTC: ATGAACACCGATTTGGTCG
ACACTAGACGTAAGCACAG: CACTAGACGTAAGCACAGG
CAACTCTACATTACGCATC: AACTCTACATTACGCATCC
GGAAGCCTCCTGATCTAAA: GAAGCCTCCTGATCTAAAT
CTTAAAGAGCGTTAAACAA: TTAAAGAGCGTTAAACAAC
CTACATTACGCATCCTCCG: TACATTACGCATCCTCCGG
ATGCGCTGCAGTACTTCTG: TGCGCTGCAGTACTTCTGG
CTCCGCTGAAACGGTATAT: TCCGCTGAAACGGTATATC
GCTGTGTGGCAGTACCCTA: CTGTGTGGCAGTACCCTAC
GGCAGTACCCTACCTAGCG: GCAGTACCCTACCTAGCGT
GACTGTACCGCATCACCAC: ACTGTACCGCATCACCACT
ACAGCTCCATCAAGCCTTC: CAGCTCCATCAAGCCTTCT
CTGTCGCGTGGTGACAGGA: TGTCGCGTGGTGACAGGAC
CGAAATTTGTGAGACATCC: GAAATTTGTGAGACATCCT
GGCACTTCGCGGTCTCGGT: GCACTTCGCGGTCTCGGTC
CTCCGGCTGCCCTGTTCAC: TCCGGCTGCCCTGTTCACC
GCTTAAGGGGTAGCGTCCT: CTTAAGGGGTAGCGTCCTT
CCAAAAGTGCACGCTGTGT: CAAAAGTGCACGCTGTGTG
CACAGGCGTGCGAAGAGTA: ACAGGCGTGCGAAGAGTAG
TGCCGATACAAGTAGTTCA: GCCGATACAAGTAGTTCAA
CTTCGAACCTGGGGAGACG: TTCGAACCTGGGGAGACGC
TACTGCCGATACAAGTAGT: ACTGCCGATACAAGTAGTT
TTGCCGCCGATGAGACTTA: TGCCGCCGATGAGACTTAA
TGTGCGTCATATACCAAGT: GTGCGTCATATACCAAGTT
TCGGCTGAATTAAACATGC: CGGCTGAATTAAACATGCG
GAGCGCCTGGTCAACTGGT: AGCGCCTGGTCAACTGGTA
ACATACCAACGGGCGCGAG: CATACCAACGGGCGCGAGT
TAGAACGGTAGATGTTGAT: AGAACGGTAGATGTTGATT
TCGCGTGGTGACAGGACGA: CGCGTGGTGACAGGACGAG
TTCGCACCCTTCAACTCTA: TCGCACCCTTCAACTCTAC
AAGGCAATTACGGCGCTAG: AGGCAATTACGGCGCTAGC
GGCAATTACGGCGCTAGCA: GCAATTACGGCGCTAGCAA
GCACAGCAAAGTTTTGACT: CACAGCAAAGTTTTGACTG
GTGCCACACTGACCCAGAC: TGCCACACTGACCCAGACT
TCGCTATCTCAGTGATGCT: CGCTATCTCAGTGATGCTG
CGCGTGGTGACAGGACGAG: GCGTGGTGACAGGACGAGT
TAACAGTTGGTGTCTCGGT: AACAGTTGGTGTCTCGGTA
CTGCGCATCCTAGATCATG: TGCGCATCCTAGATCATGC
GGTCAACTGGTATGTCTCA: GTCAACTGGTATGTCTCAC
CCTGTTCACCTGACTGTAC: CTGTTCACCTGACTGTACC
CATACATGAGACTTAAAGA: ATACATGAGACTTAAAGAG
AGACTACTAATGCATTAGA: GACTACTAATGCATTAGAT
CGCCTACGATCAGTTTGTC: GCCTACGATCAGTTTGTCA
GTCGGCTCACACGACAATA: TCGGCTCACACGACAATAG
CTGCCAAAAGTGCACGCTG: TGCCAAAAGTGCACGCTGT
GTGCGGCTGGGCACTTCGC: TGCGGCTGGGCACTTCGCG
GCATTGCATAGCTCTATGC: CATTGCATAGCTCTATGCT
TCTCCTGGAACTGGTAACT: CTCCTGGAACTGGTAACTT
ACCGATTTGGTCGAACCCA: CCGATTTGGTCGAACCCAG
ACTTCGAACCTGGGGAGAC: CTTCGAACCTGGGGAGACG
TTCGGCAAGGTACATCTCC: TCGGCAAGGTACATCTCCT
GCCCCATACATGAGACTTA: CCCCATACATGAGACTTAA
TGTTCACCACTAGCGCATT: GTTCACCACTAGCGCATTG
GAGGAGAACGATCTTGAAC: AGGAGAACGATCTTGAACG
AATGCTTAAGGGGTAGCGT: ATGCTTAAGGGGTAGCGTC
CTGGTCGGCTCACACGACA: TGGTCGGCTCACACGACAA
GTGCGTCATATACCAAGTT: TGCGTCATATACCAAGTTT
AGTACTCTTGATCGGAAAG: GTACTCTTGATCGGAAAGT
GAGGACATACCAACGGGCG: AGGACATACCAACGGGCGC
TCGAACCTGGGGAGACGCT: CGAACCTGGGGAGACGCTG
ATTCGCGAGGTCCGTTTGA: TTCGCGAGGTCCGTTTGAG
AGGTCCAAACTAGAGTTGG: GGTCCAAACTAGAGTTGGC
GTCCAGCCTCCGGCTGCCC: TCCAGCCTCCGGCTGCCCT
GGCAAGGTACATCTCCTGG: GCAAGGTACATCTCCTGGA
TTGATCGGAAAGTTACGCC: TGATCGGAAAGTTACGCCC
ATTCGTTCGCACAAAATGC: TTCGTTCGCACAAAATGCT
AAGTTAGACTAGTGTTCAC: AGTTAGACTAGTGTTCACG
AGCCTTCTTTCACGATTTA: GCCTTCTTTCACGATTTAC
TAGTTCAATGTACCTACGA: AGTTCAATGTACCTACGAG
GACATCCTCCTCTATCGGC: ACATCCTCCTCTATCGGCT
AAACTGAGACGACTACAGC: AACTGAGACGACTACAGCT
CATCAAGCCTTCTTTCACG: ATCAAGCCTTCTTTCACGA
CATTACGCATCCTCCGGTT: ATTACGCATCCTCCGGTTT
CTCTATCGGCTGAATTAAA: TCTATCGGCTGAATTAAAC
GTTCGCACAAAATGCTTAA: TTCGCACAAAATGCTTAAG
TTTCAATGACCTTTCAATA: TTCAATGACCTTTCAATAT
ATGTCAATAACCGCTACTC: TGTCAATAACCGCTACTCG
TCTCGGTCATCAGCTATCA: CTCGGTCATCAGCTATCAC
GACCGCTTGACACACCGAC: ACCGCTTGACACACCGACA
GACCGCATGAGAATGGTTC: ACCGCATGAGAATGGTTCG
AAAGTTTTGACTGATCCTT: AAGTTTTGACTGATCCTTA
CCATATGCTGTTCACCACT: CATATGCTGTTCACCACTA
ACACACCGACAAACTGAGA: CACACCGACAAACTGAGAC
CGTTTTGCCTGGAGGATGA: GTTTTGCCTGGAGGATGAA
CATACCAACGGGCGCGAGT: ATACCAACGGGCGCGAGTA
ACACTCCGATGCACCATAT: CACTCCGATGCACCATATG
TAGGTATCTTTCGGTACCA: AGGTATCTTTCGGTACCAA
AGAGTACTCTTGATCGGAA: GAGTACTCTTGATCGGAAA
AATTCGCGAGGTCCGTTTG: ATTCGCGAGGTCCGTTTGA
CGTCCGGTGCGTTGCTTAG: GTCCGGTGCGTTGCTTAGT
GCCTCCGGCTGCCCTGTTC: CCTCCGGCTGCCCTGTTCA
TCGATCTATTGGAGTCTAG: CGATCTATTGGAGTCTAGA
TAATGCATTAGATGACTCA: AATGCATTAGATGACTCAA
CTGTGTGGCAGTACCCTAC: TGTGTGGCAGTACCCTACC
AGATCCTGTGTACTGCCGA: GATCCTGTGTACTGCCGAT
GCAAAGAGACCGCATGAGA: CAAAGAGACCGCATGAGAA
ATAGCTCTATGCTTCGTCC: TAGCTCTATGCTTCGTCCA
GTCAAGCCGGTTAGCGAAG: TCAAGCCGGTTAGCGAAGT
GCTTGTTCTCGTCTACAGG: CTTGTTCTCGTCTACAGGC
AGCGCCTGGTCAACTGGTA: GCGCCTGGTCAACTGGTAT
TTTGTCACGGACGTAAGCT: TTGTCACGGACGTAAGCTT
CCTACGAGACCGAGCCACG: CTACGAGACCGAGCCACGA
TGACGGAAGCCTCCTGATC: GACGGAAGCCTCCTGATCT
CCGATGCACCATATGCTGT: CGATGCACCATATGCTGTT
CCCTGCGAAACGTAACAGC: CCTGCGAAACGTAACAGCA
GTACCTTCACGAGCGAGAG: TACCTTCACGAGCGAGAGG
AGGGGTAGCGTCCTTTTCC: GGGGTAGCGTCCTTTTCCT
TATAGCCCCTGCGAAACGT: ATAGCCCCTGCGAAACGTA
CTACCTAGCGTTACACTAA: TACCTAGCGTTACACTAAA
ACCGAGCCACGAACACATG: CCGAGCCACGAACACATGC
CAGTGAGGTTTGATCGGGT: AGTGAGGTTTGATCGGGTC
TGCGCGTCCGGTGCGTTGC: GCGCGTCCGGTGCGTTGCT
TTTCGTGAGGTAGATCCCT: TTCGTGAGGTAGATCCCTC
GTGACAGGACGAGTGTCTG: TGACAGGACGAGTGTCTGG
TCAACTGGTATGTCTCACC: CAACTGGTATGTCTCACCA
GGTAGATCCCTCTGCGCAT: GTAGATCCCTCTGCGCATC
TGTTCTAGAACGCGGCTGA: GTTCTAGAACGCGGCTGAG
TGGCCAAGGTCCTTGTTCT: GGCCAAGGTCCTTGTTCTA
TAACGGACCTGCTTGTGCG: AACGGACCTGCTTGTGCGG
GCGCGTCCGGTGCGTTGCT: CGCGTCCGGTGCGTTGCTT
CTAGCGCATTGCATAGCTC: TAGCGCATTGCATAGCTCT
CGCTATCGTACCTTAACGG: GCTATCGTACCTTAACGGA
CTAGATCCTGTGTACTGCC: TAGATCCTGTGTACTGCCG
TGTACTGCCGATACAAGTA: GTACTGCCGATACAAGTAG
TCTGGCCAAGGTCCTTGTT: CTGGCCAAGGTCCTTGTTC
TGTCTCGGTATATCGCAAA: GTCTCGGTATATCGCAAAG
CTCTTGATCGGAAAGTTCA: TCTTGATCGGAAAGTTCAA
TCAAGCCGGTTAGCGAAGT: CAAGCCGGTTAGCGAAGTT
TCCTGTGTACTGCCGATAC: CCTGTGTACTGCCGATACA
GGGGTAGCGTCCTTTTCCT: GGGTAGCGTCCTTTTCCTT
TGTCTGGCCAAGGTCCTTG: GTCTGGCCAAGGTCCTTGT
CACGGACGTAAGCTTGTTC: ACGGACGTAAGCTTGTTCT
GCACAAAATGCTTAAGGGG: CACAAAATGCTTAAGGGGT
CCTGGAGGATGAACGGATT: CTGGAGGATGAACGGATTA
GTAGGAAAAGCGTCCGACG: TAGGAAAAGCGTCCGACGA
AGCGTCGGGTGGTATACAC: GCGTCGGGTGGTATACACC
CTGGCACAATTCGCGAGGT: TGGCACAATTCGCGAGGTC
CCAAACTAGAGTTGGCACT: CAAACTAGAGTTGGCACTC
GCTGACTCCTGGCACAATT: CTGACTCCTGGCACAATTC
GATGACGGAAGCCTCCTGA: ATGACGGAAGCCTCCTGAT
GACCTGCTTGTGCGGCTGG: ACCTGCTTGTGCGGCTGGG
CCTGGGGAGACGCTGGTCG: CTGGGGAGACGCTGGTCGG
TACGCATCCTCCGGTTTTG: ACGCATCCTCCGGTTTTGA
AGCAAAGTTTTGACTGATC: GCAAAGTTTTGACTGATCC
GTACTGCCGATACAAGTAG: TACTGCCGATACAAGTAGT
GTGGTATACACCGTAGGCT: TGGTATACACCGTAGGCTT
TTCGTGAGGTAGATCCCTC: TCGTGAGGTAGATCCCTCT
TGAATTAAACATGCGCTGC: GAATTAAACATGCGCTGCA
AGACCGAGCCACGAACACA: GACCGAGCCACGAACACAT
TACCTTAACGGACCTGCTT: ACCTTAACGGACCTGCTTG
AAACTAGAGTTGGCACTCT: AACTAGAGTTGGCACTCTT
GTTATTTGGAAAGGGCAGT: TTATTTGGAAAGGGCAGTC
ACAAGTAGTTCAATGTACC: CAAGTAGTTCAATGTACCT
GATGAACGGATTATTCGCC: ATGAACGGATTATTCGCCT
TGGTATACACCGTAGGCTT: GGTATACACCGTAGGCTTA
CCGACAAACTGAGACGACT: CGACAAACTGAGACGACTA
TGCTGGAGCGCCTGGTCAA: GCTGGAGCGCCTGGTCAAC
TATTCGCCTACGATCAGTT: ATTCGCCTACGATCAGTTT
TACGGTCCTCTAGATCCTG: ACGGTCCTCTAGATCCTGT
TGGTCAGGTCTGCGGTGAT: GGTCAGGTCTGCGGTGATA
TGATGTAGGAAAAGCGTCC: GATGTAGGAAAAGCGTCCG
ACTTCGCGGTCTCGGTCAT: CTTCGCGGTCTCGGTCATC
AAATTTGTGAGACATCCTC: AATTTGTGAGACATCCTCC
ATGTAGGAAAAGCGTCCGA: TGTAGGAAAAGCGTCCGAC
ACCACTAGCGCATTGCATA: CCACTAGCGCATTGCATAG
GGACATACCAACGGGCGCG: GACATACCAACGGGCGCGA
CCCCTGCGAAACGTAACAG: CCCTGCGAAACGTAACAGC
AATCCGGGAAGTGCGCGTC: ATCCGGGAAGTGCGCGTCC
AGTCAAGTTAGACTAGTGT: GTCAAGTTAGACTAGTGTT
TTCACCTGACTGTACCGCA: TCACCTGACTGTACCGCAT
CCAACGGGCGCGAGTAGTC: CAACGGGCGCGAGTAGTCA
TCGCAAAGAGACCGCATGA: CGCAAAGAGACCGCATGAG
GTCTGCGGTGATAGAAGCC: TCTGCGGTGATAGAAGCCA
GACACACCGACAAACTGAG: ACACACCGACAAACTGAGA
CCTTCACGAGCGAGAGGAT: CTTCACGAGCGAGAGGATT
GCAGTCTCGATTCTCCGAG: CAGTCTCGATTCTCCGAGA
AGCGAGAGGATTTACTCAG: GCGAGAGGATTTACTCAGC
AGCGTCCTTTTCCTTTCTC: GCGTCCTTTTCCTTTCTCT
GTAAGACTCTTGATCGGAA: TAAGACTCTTGATCGGAAA
CTGGAACTGGTAACTTCGA: TGGAACTGGTAACTTCGAA
GCGTCCGACGACACGTAAC: CGTCCGACGACACGTAACA
GGACGAAACTGCCAAAAGT: GACGAAACTGCCAAAAGTG
GCTGGAGCGCCTGGTCAAC: CTGGAGCGCCTGGTCAACT
TGCTTTCGTGAGGTAGATC: GCTTTCGTGAGGTAGATCC
GCAAAGTTTTGACTGATCC: CAAAGTTTTGACTGATCCT
CACCATATGCTGTTCACCA: ACCATATGCTGTTCACCAC
ACACCGTAGGCTTAAACTA: CACCGTAGGCTTAAACTAG
GAACACATGCGCTCGACCT: AACACATGCGCTCGACCTC
GACTTAAAGAGCGTTACTG: ACTTAAAGAGCGTTACTGC
GAAAGTTCAAACAGCGTGA: AAAGTTCAAACAGCGTGAT
TTACTCAGCGGTGTTCGAT: TACTCAGCGGTGTTCGATC
GGAAAGTTGGAGCTAGACT: GAAAGTTGGAGCTAGACTA
TGATAATCGTCATCCCGTA: GATAATCGTCATCCCGTAC
GCGCGTTTTCCAAGCGTCG: CGCGTTTTCCAAGCGTCGG
GACTCAAAGTGTGACAGAG: ACTCAAAGTGTGACAGAGG
GTTTCTGAAAGAGGCTTCG: TTTCTGAAAGAGGCTTCGG
GGTGTCTCGGTATATCGCA: GTGTCTCGGTATATCGCAA
AAACGGTATATCGGGCACA: AACGGTATATCGGGCACAC
TCCAGTCCCTTGACACTAG: CCAGTCCCTTGACACTAGA
TAGAGGAGAACGATCTTGA: AGAGGAGAACGATCTTGAA
ACCCGATTGCTGCTAGCCG: CCCGATTGCTGCTAGCCGA
CCACAGGCGTGCGAAGAGT: CACAGGCGTGCGAAGAGTA
TGAGACTTAAAGAGCGTTA: GAGACTTAAAGAGCGTTAC GAGACTTAAAGAGCGTTAA
CGATGCACCATATGCTGTT: GATGCACCATATGCTGTTC
AGTTTCTGAAAGAGGCTTC: GTTTCTGAAAGAGGCTTCG
GAGGTAGATCCCTCTGCGC: AGGTAGATCCCTCTGCGCA
GCGTGCGAAGAGTAGAACG: CGTGCGAAGAGTAGAACGG
CTGTGTACTGCCGATACAA: TGTGTACTGCCGATACAAG
GCTACTCGATTCAAGGTTA: CTACTCGATTCAAGGTTAT
TCTAGTGGGTAGTCAGTAC: CTAGTGGGTAGTCAGTACC
TCCCTGTAGGTATCTTTCG: CCCTGTAGGTATCTTTCGG
ACGAAACTGCCAAAAGTGC: CGAAACTGCCAAAAGTGCA
GGAGAACGATCTTGAACGC: GAGAACGATCTTGAACGCT
TATGAGACTTAAAGAGCGT: ATGAGACTTAAAGAGCGTT
GCCGCAATCAGGCCTCGCA: CCGCAATCAGGCCTCGCAC
GTACATCTCCTGGAACTGG: TACATCTCCTGGAACTGGT
CCCTGTTCACCTGACTGTA: CCTGTTCACCTGACTGTAC
TTACTACCTCATTCGTTCG: TACTACCTCATTCGTTCGC
GTCTCACCACGATGACGGA: TCTCACCACGATGACGGAA
AGTGTCTGGCCAAGGTCCT: GTGTCTGGCCAAGGTCCTT
ACTTAAAGAGCGTTTTACT: CTTAAAGAGCGTTTTACTA
TAGTGGGTAGTCAGTACCA: AGTGGGTAGTCAGTACCAC
ATTCGGACCGCTTGACACA: TTCGGACCGCTTGACACAC
CGTTACTGCTGACTCCTGG: GTTACTGCTGACTCCTGGC
TTAAGTAGAAAGTTGTGCG: TAAGTAGAAAGTTGTGCGT
CGGACCGCTTGACACACCG: GGACCGCTTGACACACCGA
TAAGCTTGTGCGGCTGCGT: AAGCTTGTGCGGCTGCGTA
TTGCTTTCGTGAGGTAGAT: TGCTTTCGTGAGGTAGATC
CGCATCACCACTGCTCAGC: GCATCACCACTGCTCAGCG
CACCTGACTGTACCGCATC: ACCTGACTGTACCGCATCA
GTCGCGTGGTGACAGGACG: TCGCGTGGTGACAGGACGA
CGATTCTCCGAGAGTACTC: GATTCTCCGAGAGTACTCT
TGGTCAACTGGTATGTCTC: GGTCAACTGGTATGTCTCA
TACAGCTCCATCAAGCCTT: ACAGCTCCATCAAGCCTTC
TGCCTGGAGGATGAACGGA: GCCTGGAGGATGAACGGAT
AGTTGGCACTCTTGATCGG: GTTGGCACTCTTGATCGGA
GAATTAAACATGCGCTGCA: AATTAAACATGCGCTGCAG
TTTGTGAGACATCCTCCTC: TTGTGAGACATCCTCCTCT
AGTACCCTACCTAGCGTTA: GTACCCTACCTAGCGTTAC
AAGAGGCTTCGGCCGTGAT: AGAGGCTTCGGCCGTGATC
CAGTGATGCTGGAGCGCCT: AGTGATGCTGGAGCGCCTG
TTCCAAGCGTCGGGTGGTA: TCCAAGCGTCGGGTGGTAT
CCAGACTGATAATCGTCAT: CAGACTGATAATCGTCATC
TCGTCTTTCGCTGTCGCGT: CGTCTTTCGCTGTCGCGTG
CGTGATGTAGGAAAAGCGT: GTGATGTAGGAAAAGCGTC
GCTATTCGGACCGCTTGAC: CTATTCGGACCGCTTGACA
AAAGAGCGTTAAACAACAT: AAGAGCGTTAAACAACATA
GGTATGTCTCACCACGATG: GTATGTCTCACCACGATGA
GCGTTACTGCTGACTCCTG: CGTTACTGCTGACTCCTGG
TTACTGCTGACTCCTGGCA: TACTGCTGACTCCTGGCAC
GCACCAACTTGCTTTCGTG: CACCAACTTGCTTTCGTGA
CACTGGTCAGGTCTGCGGT: ACTGGTCAGGTCTGCGGTG
ATCAGGCCTCGCACAGCAA: TCAGGCCTCGCACAGCAAA
TCTGCGGTGATAGAAGCCA: CTGCGGTGATAGAAGCCAC
CTGTTCACCTGACTGTACC: TGTTCACCTGACTGTACCG
TCATCCCGTACACGTATTT: CATCCCGTACACGTATTTC
TGATCGGAAAGTTGGAGCT: GATCGGAAAGTTGGAGCTA
CGGGTGGGACTAATGAACA: GGGTGGGACTAATGAACAC
GATCCTTAAGACCGTCCTG: ATCCTTAAGACCGTCCTGT
GCTCTATGCTTCGTCCAGC: CTCTATGCTTCGTCCAGCC
GTTACACTAAAGTCAAGTT: TTACACTAAAGTCAAGTTA
TGATGAGACTTAAAGAGCG: GATGAGACTTAAAGAGCGT
TTCGGACCGCTTGACACAC: TCGGACCGCTTGACACACC
ACGCTCGAAATTTGTGAGA: CGCTCGAAATTTGTGAGAC
ATTTACTCAGCGGTGTTCG: TTTACTCAGCGGTGTTCGA
CCGATTTGGTCGAACCCAG: CGATTTGGTCGAACCCAGC
CGAGGAAAAAACTTGGCTT: GAGGAAAAAACTTGGCTTC
ATCTCCTGGAACTGGTAAC: TCTCCTGGAACTGGTAACT
CTGGAGCGCCTGGTCAACT: TGGAGCGCCTGGTCAACTG
GGCAGTCTCGATTCTCCGA: GCAGTCTCGATTCTCCGAG
TCGGTCATCAGCTATCACG: CGGTCATCAGCTATCACGG
CAAAGAGACCGCATGAGAA: AAAGAGACCGCATGAGAAT
TGTGCGGCTGCGTAAGACT: GTGCGGCTGCGTAAGACTC
GCACGGTATAGAGGAGAAC: CACGGTATAGAGGAGAACG
ACGGATTATTCGCCTACGA: CGGATTATTCGCCTACGAT
CTGCTTGTGCGGCTGGGCA: TGCTTGTGCGGCTGGGCAC
TCAAGTTAGACTAGTGTTC: CAAGTTAGACTAGTGTTCA
CTGAATTAAACATGCGCTG: TGAATTAAACATGCGCTGC
TAAACTAGTTAAGTAGAAA: AAACTAGTTAAGTAGAAAG
CACTGCTCAGCGTGCCACA: ACTGCTCAGCGTGCCACAC
CTGGTAACTTCGAACCTGG: TGGTAACTTCGAACCTGGG
TGACTGACTCAAAGTGTGA: GACTGACTCAAAGTGTGAC
GGACCTGCTTGTGCGGCTG: GACCTGCTTGTGCGGCTGG
CGACGACACGTAACAGTTG: GACGACACGTAACAGTTGG
AATAAGCTTGTGCGGCTGC: ATAAGCTTGTGCGGCTGCG
ACGATCTTGAACGCTCGAA: CGATCTTGAACGCTCGAAA
GACCCAGACTGATAATCGT: ACCCAGACTGATAATCGTC
GCGGCTGCGTAAGACTCTT: CGGCTGCGTAAGACTCTTG
TGTTCACCTGACTGTACCG: GTTCACCTGACTGTACCGC
AAACGAACCCGGCCTGGCA: AACGAACCCGGCCTGGCAC
CGGTACCAATAAGCTTGTG: GGTACCAATAAGCTTGTGC
ACCTTTCAATATCGTCTTT: CCTTTCAATATCGTCTTTC
CTACGATCAGTTTGTCACG: TACGATCAGTTTGTCACGG
TAGCCGAAACGAACCCGGC: AGCCGAAACGAACCCGGCC
GCGAGTAGTCATAGTTAGT: CGAGTAGTCATAGTTAGTC
ATCAGCTATCACGGGTGGG: TCAGCTATCACGGGTGGGA
TGATAGAAGCCACGAGGAA: GATAGAAGCCACGAGGAAA
CGTCTTTCGCTGTCGCGTG: GTCTTTCGCTGTCGCGTGG
TTCGCTGTCGCGTGGTGAC: TCGCTGTCGCGTGGTGACA
TCCATCAAGCCTTCTTTCA: CCATCAAGCCTTCTTTCAC
CTCGACCTCCCTGTAGGTA: TCGACCTCCCTGTAGGTAT
GAAGGGTTTCAATGACCTT: AAGGGTTTCAATGACCTTT
ACACTAAGGCAATTACGGC: CACTAAGGCAATTACGGCG
GGAAAGTTTATTGCCGCCG: GAAAGTTTATTGCCGCCGA
AGCCGTGTACCTTCACGAG: GCCGTGTACCTTCACGAGC
GTGAGGTTTGATCGGGTCT: TGAGGTTTGATCGGGTCTG
GTGACAGAGGAAGCCGTGT: TGACAGAGGAAGCCGTGTA
TGGTCGAACCCAGCTATTC: GGTCGAACCCAGCTATTCG
CGGAAAGTTGGAGCTAGAC: GGAAAGTTGGAGCTAGACT
GCACCCTTCAACTCTACAT: CACCCTTCAACTCTACATT
GTGCTGACTGACTCAAAGT: TGCTGACTGACTCAAAGTG
GAACCTGGGGAGACGCTGG: AACCTGGGGAGACGCTGGT
TCCGCTGAAACGGTATATC: CCGCTGAAACGGTATATCG
TAGCGTTACACTAAAGTCA: AGCGTTACACTAAAGTCAA
CGCATTGCATAGCTCTATG: GCATTGCATAGCTCTATGC
TTGGTGTCTCGGTATATCG: TGGTGTCTCGGTATATCGC
TTGATCGGAAAGTTGGAGC: TGATCGGAAAGTTGGAGCT
GGATGAACGGATTATTCGC: GATGAACGGATTATTCGCC
CCGTTTGAGACTACTAATG: CGTTTGAGACTACTAATGC
TCACGAGCGAGAGGATTTA: CACGAGCGAGAGGATTTAC
AGTACTTCTGGATGTCAAT: GTACTTCTGGATGTCAATA
TAAAGAGCGTTTTACTACC: AAAGAGCGTTTTACTACCT
CGTAGGCTTAAACTAGTTA: GTAGGCTTAAACTAGTTAA
CGGTCATCAGCTATCACGG: GGTCATCAGCTATCACGGG
CCACGATGACGGAAGCCTC: CACGATGACGGAAGCCTCC
ACGACTACAGCTCCATCAA: CGACTACAGCTCCATCAAG
GTTACGCCCCATACATGAG: TTACGCCCCATACATGAGA
CTGTACCGCATCACCACTG: TGTACCGCATCACCACTGC
CTATGCTTCGTCCAGCCTC: TATGCTTCGTCCAGCCTCC
GCGCATCCTAGATCATGCC: CGCATCCTAGATCATGCCG
GAACGATCTTGAACGCTCG: AACGATCTTGAACGCTCGA
CCAATAAGCTTGTGCGGCT: CAATAAGCTTGTGCGGCTG
TCCGAGAGTACTCTTGATC: CCGAGAGTACTCTTGATCG
TCGCGAGGTCCGTTTGAGA: CGCGAGGTCCGTTTGAGAC
GGTATACACCGTAGGCTTA: GTATACACCGTAGGCTTAA
CCTCTGCGCATCCTAGATC: CTCTGCGCATCCTAGATCA
CCGATGAGACTTAAAGAGC: CGATGAGACTTAAAGAGCG
GCATGAGAATGGTTCGGCA: CATGAGAATGGTTCGGCAA
GTCATATACCAAGTTTCGC: TCATATACCAAGTTTCGCA
TTCAATGACCTTTCAATAT: TCAATGACCTTTCAATATC
CCGTCCTGTGCTGACTGAC: CGTCCTGTGCTGACTGACT
GCTCGACCTCCCTGTAGGT: CTCGACCTCCCTGTAGGTA
CTGCTCAGCGTGCCACACT: TGCTCAGCGTGCCACACTG
TGGTTCGGCAAGGTACATC: GGTTCGGCAAGGTACATCT
TTCGTCCAGCCTCCGGCTG: TCGTCCAGCCTCCGGCTGC
TCACGCTATCGTACCTTAA: CACGCTATCGTACCTTAAC
TTTTACTACCTCATTCGTT: TTTACTACCTCATTCGTTC
ACGATCAGTTTGTCACGGA: CGATCAGTTTGTCACGGAC
GATCTTGAACGCTCGAAAT: ATCTTGAACGCTCGAAATT
GACTCTTGATCGGAAAGTT: ACTCTTGATCGGAAAGTTG
TATGCTGTTCACCACTAGC: ATGCTGTTCACCACTAGCG
ACTCTTGATCGGAAAGTTT: CTCTTGATCGGAAAGTTTA
AAAGAGACCGCATGAGAAT: AAGAGACCGCATGAGAATG
GTCTGTCTCGCTATCTCAG: TCTGTCTCGCTATCTCAGT
ACATGCGCTGCAGTACTTC: CATGCGCTGCAGTACTTCT
TCGGCAAGGTACATCTCCT: CGGCAAGGTACATCTCCTG
TCGGGCACACTAAGGCAAT: CGGGCACACTAAGGCAATT
AGGTCCTTGTTCTAGAACG: GGTCCTTGTTCTAGAACGC
GTGCGAAGAGTAGAACGGT: TGCGAAGAGTAGAACGGTA
AAAGTTCAAACAGCGTGAT: AAGTTCAAACAGCGTGATG
GAAAGGGCAGTCTCGATTC: AAAGGGCAGTCTCGATTCT
TTGTGCGTCATATACCAAG: TGTGCGTCATATACCAAGT
CTCTTGATCGGAAAGTTTA: TCTTGATCGGAAAGTTTAT
ACGAGTGTCTGGCCAAGGT: CGAGTGTCTGGCCAAGGTC
AATTGAGCCGTGATGTAGG: ATTGAGCCGTGATGTAGGA
ACTCTACATTACGCATCCT: CTCTACATTACGCATCCTC
CACTAAGGCAATTACGGCG: ACTAAGGCAATTACGGCGC
AACTCTACATTACGCATCC: ACTCTACATTACGCATCCT
AAAGTCAAGTTAGACTAGT: AAGTCAAGTTAGACTAGTG
GTCAGGTCTGCGGTGATAG: TCAGGTCTGCGGTGATAGA
CGTGAGGTAGATCCCTCTG: GTGAGGTAGATCCCTCTGC
GGGTCTGTCTCGCTATCTC: GGTCTGTCTCGCTATCTCA
GGCACACTAAGGCAATTAC: GCACACTAAGGCAATTACG
CAGCGCGTTTTCCAAGCGT: AGCGCGTTTTCCAAGCGTC
TTCAAGGTTATTTGGAAAG: TCAAGGTTATTTGGAAAGG
ATGTCTCACCACGATGACG: TGTCTCACCACGATGACGG
TCCTGATCTAAATCCGGGA: CCTGATCTAAATCCGGGAA
CCTGCTTGTGCGGCTGGGC: CTGCTTGTGCGGCTGGGCA
TAGACGTAAGCACAGGTCC: AGACGTAAGCACAGGTCCA
GGTACCAATAAGCTTGTGC: GTACCAATAAGCTTGTGCG
GAGGATTTACTCAGCGGTG: AGGATTTACTCAGCGGTGT
CAGGCCGCAATCAGGCCTC: AGGCCGCAATCAGGCCTCG
AGGAAAAGCGTCCGACGAC: GGAAAAGCGTCCGACGACA
TTAAAGAGCGTTCCAGCGC: TAAAGAGCGTTCCAGCGCG
GACACTAGACGTAAGCACA: ACACTAGACGTAAGCACAG
TTACGCATCCTCCGGTTTT: TACGCATCCTCCGGTTTTG
AACTGGTATGTCTCACCAC: ACTGGTATGTCTCACCACG
ATCAAGCCTTCTTTCACGA: TCAAGCCTTCTTTCACGAT
ACTCCACTGGTCAGGTCTG: CTCCACTGGTCAGGTCTGC
GTCGAACCCAGCTATTCGG: TCGAACCCAGCTATTCGGA
AAACTGCCAAAAGTGCACG: AACTGCCAAAAGTGCACGC
CGAACCCAGCTATTCGGAC: GAACCCAGCTATTCGGACC
AAAAGCGTCCGACGACACG: AAAGCGTCCGACGACACGT
GTTCACGCTATCGTACCTT: TTCACGCTATCGTACCTTA
AATTTGTGAGACATCCTCC: ATTTGTGAGACATCCTCCT
TTGATCGGAAAGTTCAAAC: TGATCGGAAAGTTCAAACA
CGTGGTGACAGGACGAGTG: GTGGTGACAGGACGAGTGT
GAGGATGAACGGATTATTC: AGGATGAACGGATTATTCG
GTACCGCATCACCACTGCT: TACCGCATCACCACTGCTC
GCCAAGGTCCTTGTTCTAG: CCAAGGTCCTTGTTCTAGA
CTCGGTCATCAGCTATCAC: TCGGTCATCAGCTATCACG
ATCGTCTTTCGCTGTCGCG: TCGTCTTTCGCTGTCGCGT
GTTGGTGTCTCGGTATATC: TTGGTGTCTCGGTATATCG
GTTTCGCACCCTTCAACTC: TTTCGCACCCTTCAACTCT
GTTGGAGCTAGACTATGAG: TTGGAGCTAGACTATGAGA
TGTACCGCATCACCACTGC: GTACCGCATCACCACTGCT
CCCTACCTAGCGTTACACT: CCTACCTAGCGTTACACTA
GATGTTGATTAACACTCCA: ATGTTGATTAACACTCCAC
AAGTGCGCGTCCGGTGCGT: AGTGCGCGTCCGGTGCGTT
TAAAGAGCGTTAAACAACA: AAAGAGCGTTAAACAACAT
CAGCCTCCGGCTGCCCTGT: AGCCTCCGGCTGCCCTGTT
CTGGCCAAGGTCCTTGTTC: TGGCCAAGGTCCTTGTTCT
GGTTTGATCGGGTCTGTCT: GTTTGATCGGGTCTGTCTC
GCGAGAGGATTTACTCAGC: CGAGAGGATTTACTCAGCG
TCCTCCGGTTTTGAGGACA: CCTCCGGTTTTGAGGACAT
TTATTTGGAAAGGGCAGTC: TATTTGGAAAGGGCAGTCT
GGAAGTGCGCGTCCGGTGC: GAAGTGCGCGTCCGGTGCG
ATGACTCAATTGAGCCGTG: TGACTCAATTGAGCCGTGA
TACGATCAGTTTGTCACGG: ACGATCAGTTTGTCACGGA
ACCTGCTTGTGCGGCTGGG: CCTGCTTGTGCGGCTGGGC
GTTTTCCAAGCGTCGGGTG: TTTTCCAAGCGTCGGGTGG
TCCTGTGCTGACTGACTCA: CCTGTGCTGACTGACTCAA
CAAACTGAGACGACTACAG: AAACTGAGACGACTACAGC
GGTTTTGAGGACATACCAA: GTTTTGAGGACATACCAAC
CTAGAGTTGGCACTCTTGA: TAGAGTTGGCACTCTTGAT
TCGGAAAGTTTATTGCCGC: CGGAAAGTTTATTGCCGCC
AACCCGGCCTGGCACCAAC: ACCCGGCCTGGCACCAACT
AAGTTTCGCACCCTTCAAC: AGTTTCGCACCCTTCAACT
TGCACCATATGCTGTTCAC: GCACCATATGCTGTTCACC
GTCCCTTGACACTAGACGT: TCCCTTGACACTAGACGTA
GTTCCCTGCAGTGAGGTTT: TTCCCTGCAGTGAGGTTTG
AAGTGTGACAGAGGAAGCC: AGTGTGACAGAGGAAGCCG
ATTTGGAAAGGGCAGTCTC: TTTGGAAAGGGCAGTCTCG
AAAGTTTATTGCCGCCGAT: AAGTTTATTGCCGCCGATG
ATCTAAATCCGGGAAGTGC: TCTAAATCCGGGAAGTGCG
TTGCATAGCTCTATGCTTC: TGCATAGCTCTATGCTTCG
TGATCGGGTCTGTCTCGCT: GATCGGGTCTGTCTCGCTA
GACGCTGGTCGGCTCACAC: ACGCTGGTCGGCTCACACG
TGTGCGGCTGGGCACTTCG: GTGCGGCTGGGCACTTCGC
CCGTGATCCACAGGCGTGC: CGTGATCCACAGGCGTGCG
ATGAACGGATTATTCGCCT: TGAACGGATTATTCGCCTA
TCCTGGCACAATTCGCGAG: CCTGGCACAATTCGCGAGG
GGAGTCTAGATCTCCGCTG: GAGTCTAGATCTCCGCTGA
CTTAAAGAGCGTTACTGCT: TTAAAGAGCGTTACTGCTG
AAGCTTGTGCGGCTGCGTA: AGCTTGTGCGGCTGCGTAA
CACAGGTCCAAACTAGAGT: ACAGGTCCAAACTAGAGTT
AGAACCCGATTGCTGCTAG: GAACCCGATTGCTGCTAGC
TGAGACTTAAAGAGCGTTC: GAGACTTAAAGAGCGTTCC
CTGACTGTACCGCATCACC: TGACTGTACCGCATCACCA
CCGCCGATGAGACTTAAAG: CGCCGATGAGACTTAAAGA
CACACTGACCCAGACTGAT: ACACTGACCCAGACTGATA
CGTCGGGTGGTATACACCG: GTCGGGTGGTATACACCGT
GTCAGTACCACCACACTCC: TCAGTACCACCACACTCCG
TTTACGGTCCTCTAGATCC: TTACGGTCCTCTAGATCCT
CAATGTACCTACGAGACCG: AATGTACCTACGAGACCGA
CGCACAAAATGCTTAAGGG: GCACAAAATGCTTAAGGGG
CGGTGCGTTGCTTAGTTAG: GGTGCGTTGCTTAGTTAGA
GAGCTAGACTATGAGACTT: AGCTAGACTATGAGACTTA
TGTAGGAAAAGCGTCCGAC: GTAGGAAAAGCGTCCGACG
GAGACGACTACAGCTCCAT: AGACGACTACAGCTCCATC
AGACTTAAAGAGCGTTAAA: GACTTAAAGAGCGTTAAAC
TTGATCGGAAAGTTTATTG: TGATCGGAAAGTTTATTGC
TGAGACATCCTCCTCTATC: GAGACATCCTCCTCTATCG
AAAGCGTCCGACGACACGT: AAGCGTCCGACGACACGTA
GTTCGATCTATTGGAGTCT: TTCGATCTATTGGAGTCTA
GACATACCAACGGGCGCGA: ACATACCAACGGGCGCGAG
GCGGTCTCGGTCATCAGCT: CGGTCTCGGTCATCAGCTA
TTCTGGATGTCAATAACCG: TCTGGATGTCAATAACCGC
CTAGGATATAGCCCCTGCG: TAGGATATAGCCCCTGCGA
GTGCGCGTCCGGTGCGTTG: TGCGCGTCCGGTGCGTTGC
CATCAGCTATCACGGGTGG: ATCAGCTATCACGGGTGGG
ACCCGGCCTGGCACCAACT: CCCGGCCTGGCACCAACTT
CTCTTGATCGGAAAGTTAC: TCTTGATCGGAAAGTTACG
GGATTTACTCAGCGGTGTT: GATTTACTCAGCGGTGTTC
GATAATCGTCATCCCGTAC: ATAATCGTCATCCCGTACA
TCCCGTACACGTATTTCTC: CCCGTACACGTATTTCTCT
GTCTCGATTCTCCGAGAGT: TCTCGATTCTCCGAGAGTA
CTTGAACGCTCGAAATTTG: TTGAACGCTCGAAATTTGT
CTTAAGACCGTCCTGTGCT: TTAAGACCGTCCTGTGCTG
AAAAAACTTGGCTTCTATC: AAAAACTTGGCTTCTATCG
TCACCACGATGACGGAAGC: CACCACGATGACGGAAGCC
ATCGGGCACACTAAGGCAA: TCGGGCACACTAAGGCAAT
TAGATCTCCGCTGAAACGG: AGATCTCCGCTGAAACGGT
ACATTACGCATCCTCCGGT: CATTACGCATCCTCCGGTT
CGCGAGGTCCGTTTGAGAC: GCGAGGTCCGTTTGAGACT
TTAGCGAAGTTTCTGAAAG: TAGCGAAGTTTCTGAAAGA
GCGTGGTGACAGGACGAGT: CGTGGTGACAGGACGAGTG
ATCACGGGTGGGACTAATG: TCACGGGTGGGACTAATGA
CACTAGCGCATTGCATAGC: ACTAGCGCATTGCATAGCT
ACACTCCACTGGTCAGGTC: CACTCCACTGGTCAGGTCT
TGCTGACTGACTCAAAGTG: GCTGACTGACTCAAAGTGT
AAACTAGTTAAGTAGAAAG: AACTAGTTAAGTAGAAAGT
GTACCTACGAGACCGAGCC: TACCTACGAGACCGAGCCA
TGTCAATAACCGCTACTCG: GTCAATAACCGCTACTCGA
TCTAGAACGCGGCTGAGGA: CTAGAACGCGGCTGAGGAC
CACGAGCGAGAGGATTTAC: ACGAGCGAGAGGATTTACT
TCGATTCTCCGAGAGTACT: CGATTCTCCGAGAGTACTC
TCTTTCGCTGTCGCGTGGT: CTTTCGCTGTCGCGTGGTG
CCCAGCTATTCGGACCGCT: CCAGCTATTCGGACCGCTT
CGGGTCTGTCTCGCTATCT: GGGTCTGTCTCGCTATCTC
CCGCTGAAACGGTATATCG: CGCTGAAACGGTATATCGG
AGTCTCGATTCTCCGAGAG: GTCTCGATTCTCCGAGAGT
GCTGGTCGGCTCACACGAC: CTGGTCGGCTCACACGACA
TTACGGTCCTCTAGATCCT: TACGGTCCTCTAGATCCTG
AGAAAGTTGTGCGTCATAT: GAAAGTTGTGCGTCATATA
TAACACTCCACTGGTCAGG: AACACTCCACTGGTCAGGT
TATCGTCTTTCGCTGTCGC: ATCGTCTTTCGCTGTCGCG
GGGCACTTCGCGGTCTCGG: GGCACTTCGCGGTCTCGGT
CTGGAGGATGAACGGATTA: TGGAGGATGAACGGATTAT
TTCAAACAGCGTGATGAGA: TCAAACAGCGTGATGAGAC
TACCAATAAGCTTGTGCGG: ACCAATAAGCTTGTGCGGC
GACTACAGCTCCATCAAGC: ACTACAGCTCCATCAAGCC
GGCTTAAACTAGTTAAGTA: GCTTAAACTAGTTAAGTAG
AAGTTCAAACAGCGTGATG: AGTTCAAACAGCGTGATGA
GAACCCGGCCTGGCACCAA: AACCCGGCCTGGCACCAAC
GCGTGCCACACTGACCCAG: CGTGCCACACTGACCCAGA
GCCTGGCACCAACTTGCTT: CCTGGCACCAACTTGCTTT
AGGCCTCGCACAGCAAAGT: GGCCTCGCACAGCAAAGTT
TCTCACCACGATGACGGAA: CTCACCACGATGACGGAAG
CAAAAGTGCACGCTGTGTG: AAAAGTGCACGCTGTGTGG
AGTGAGGTTTGATCGGGTC: GTGAGGTTTGATCGGGTCT
GACTGATCCTTAAGACCGT: ACTGATCCTTAAGACCGTC
GATATAGCCCCTGCGAAAC: ATATAGCCCCTGCGAAACG
TAAAGAGCGTTACTGCTGA: AAAGAGCGTTACTGCTGAC
CCTGTAGGTATCTTTCGGT: CTGTAGGTATCTTTCGGTA
CAATTGAGCCGTGATGTAG: AATTGAGCCGTGATGTAGG
AACTTGGCTTCTATCGTTC: ACTTGGCTTCTATCGTTCC
GCTATCGTACCTTAACGGA: CTATCGTACCTTAACGGAC
GTACCAATAAGCTTGTGCG: TACCAATAAGCTTGTGCGG
TCTTTCGGTACCAATAAGC: CTTTCGGTACCAATAAGCT
GGCCAAGGTCCTTGTTCTA: GCCAAGGTCCTTGTTCTAG
AAAGTTGTGCGTCATATAC: AAGTTGTGCGTCATATACC
TGGGGAGACGCTGGTCGGC: GGGGAGACGCTGGTCGGCT
GGTCTCGGTCATCAGCTAT: GTCTCGGTCATCAGCTATC
CGTTAAACAACATAACCGT: GTTAAACAACATAACCGTT
TCGTCTACAGGCCGCAATC: CGTCTACAGGCCGCAATCA
ATTAAACATGCGCTGCAGT: TTAAACATGCGCTGCAGTA
CTCTACATTACGCATCCTC: TCTACATTACGCATCCTCC
CCAAGGTCCTTGTTCTAGA: CAAGGTCCTTGTTCTAGAA
GCAGTACCCTACCTAGCGT: CAGTACCCTACCTAGCGTT
AAGACCGTCCTGTGCTGAC: AGACCGTCCTGTGCTGACT
GCGTCCGGTGCGTTGCTTA: CGTCCGGTGCGTTGCTTAG
CTTTCTCTAGTGGGTAGTC: TTTCTCTAGTGGGTAGTCA
TCTACAGGCCGCAATCAGG: CTACAGGCCGCAATCAGGC
CCTGCAGTGAGGTTTGATC: CTGCAGTGAGGTTTGATCG
CAGCTATCACGGGTGGGAC: AGCTATCACGGGTGGGACT
GTTAGAACCCGATTGCTGC: TTAGAACCCGATTGCTGCT
CTTCGGCCGTGATCCACAG: TTCGGCCGTGATCCACAGG
CGCACAGCAAAGTTTTGAC: GCACAGCAAAGTTTTGACT
TCTACATTACGCATCCTCC: CTACATTACGCATCCTCCG
AAGCTTGTTCTCGTCTACA: AGCTTGTTCTCGTCTACAG
TGATCGGAAAGTTACGCCC: GATCGGAAAGTTACGCCCC
ACCTTAACGGACCTGCTTG: CCTTAACGGACCTGCTTGT
ATCCGGGAAGTGCGCGTCC: TCCGGGAAGTGCGCGTCCG
CTGGTCAGGTCTGCGGTGA: TGGTCAGGTCTGCGGTGAT
CTAGAACGCGGCTGAGGAC: TAGAACGCGGCTGAGGACG
GACGACTACAGCTCCATCA: ACGACTACAGCTCCATCAA
CTCTTGATCGGAAAGTTGG: TCTTGATCGGAAAGTTGGA
CTAAAGTCAAGTTAGACTA: TAAAGTCAAGTTAGACTAG
GCACAGGTCCAAACTAGAG: CACAGGTCCAAACTAGAGT
ATGCCGAAGGGTTTCAATG: TGCCGAAGGGTTTCAATGA
AACCCGATTGCTGCTAGCC: ACCCGATTGCTGCTAGCCG
CCTCCGGCTGCCCTGTTCA: CTCCGGCTGCCCTGTTCAC
ATCGCAAAGAGACCGCATG: TCGCAAAGAGACCGCATGA
GTGGTGACAGGACGAGTGT: TGGTGACAGGACGAGTGTC
GCGGTGATAGAAGCCACGA: CGGTGATAGAAGCCACGAG
CACCACGATGACGGAAGCC: ACCACGATGACGGAAGCCT
TCAGCTATCACGGGTGGGA: CAGCTATCACGGGTGGGAC
CTAGACGTAAGCACAGGTC: TAGACGTAAGCACAGGTCC
CATGAGACTTAAAGAGCGT: ATGAGACTTAAAGAGCGTT
CACTCTTGATCGGAAAGTT: ACTCTTGATCGGAAAGTTC
TTGAGACTACTAATGCATT: TGAGACTACTAATGCATTA
TGGTGACAGGACGAGTGTC: GGTGACAGGACGAGTGTCT
TTGACACTAGACGTAAGCA: TGACACTAGACGTAAGCAC
TTAAGGGGTAGCGTCCTTT: TAAGGGGTAGCGTCCTTTT
GCCGATACAAGTAGTTCAA: CCGATACAAGTAGTTCAAT
GCTAGACTATGAGACTTAA: CTAGACTATGAGACTTAAA
TGACTGATCCTTAAGACCG: GACTGATCCTTAAGACCGT
ACGTAAGCACAGGTCCAAA: CGTAAGCACAGGTCCAAAC
TGCGTAAGACTCTTGATCG: GCGTAAGACTCTTGATCGG
TCCAAGCGTCGGGTGGTAT: CCAAGCGTCGGGTGGTATA
TGGAGCTAGACTATGAGAC: GGAGCTAGACTATGAGACT
AAGGTTATTTGGAAAGGGC: AGGTTATTTGGAAAGGGCA
ACACCGACAAACTGAGACG: CACCGACAAACTGAGACGA
GTATACACCGTAGGCTTAA: TATACACCGTAGGCTTAAA
CGTTTGAGACTACTAATGC: GTTTGAGACTACTAATGCA
GAGTTGGCACTCTTGATCG: AGTTGGCACTCTTGATCGG
CTCAGTGATGCTGGAGCGC: TCAGTGATGCTGGAGCGCC
TTGTGAGACATCCTCCTCT: TGTGAGACATCCTCCTCTA
GAGAATGGTTCGGCAAGGT: AGAATGGTTCGGCAAGGTA
TGACTCCTGGCACAATTCG: GACTCCTGGCACAATTCGC
CTGTTCACCACTAGCGCAT: TGTTCACCACTAGCGCATT
CAAGGTCCTTGTTCTAGAA: AAGGTCCTTGTTCTAGAAC
CACTGACCCAGACTGATAA: ACTGACCCAGACTGATAAT
CTGCTAGCCGAAACGAACC: TGCTAGCCGAAACGAACCC
ACTCTTGATCGGAAAGTTC: CTCTTGATCGGAAAGTTCA
GATTCAAGGTTATTTGGAA: ATTCAAGGTTATTTGGAAA
GTTGGCACTCTTGATCGGA: TTGGCACTCTTGATCGGAA
TCGTTCGCACAAAATGCTT: CGTTCGCACAAAATGCTTA
TTCACGATTTACGGTCCTC: TCACGATTTACGGTCCTCT
GTGGGACTAATGAACACCG: TGGGACTAATGAACACCGA
CGGTGATAGAAGCCACGAG: GGTGATAGAAGCCACGAGG
AACTGAGACGACTACAGCT: ACTGAGACGACTACAGCTC
CACGATGACGGAAGCCTCC: ACGATGACGGAAGCCTCCT
GTAGTTCAATGTACCTACG: TAGTTCAATGTACCTACGA
AGCGCGTTTTCCAAGCGTC: GCGCGTTTTCCAAGCGTCG
TCAGCGTGCCACACTGACC: CAGCGTGCCACACTGACCC
CGTTTTCCAAGCGTCGGGT: GTTTTCCAAGCGTCGGGTG
AGGATATAGCCCCTGCGAA: GGATATAGCCCCTGCGAAA
CCACGAACACATGCGCTCG: CACGAACACATGCGCTCGA
TCTCAGTGATGCTGGAGCG: CTCAGTGATGCTGGAGCGC
TGACAGAGGAAGCCGTGTA: GACAGAGGAAGCCGTGTAC
GTCAACTGGTATGTCTCAC: TCAACTGGTATGTCTCACC
CTCCTCTATCGGCTGAATT: TCCTCTATCGGCTGAATTA
TCTGGATGTCAATAACCGC: CTGGATGTCAATAACCGCT
GACTTAAAGAGCGTTTTAC: ACTTAAAGAGCGTTTTACT
CAGACTGATAATCGTCATC: AGACTGATAATCGTCATCC
CGAAGGGTTTCAATGACCT: GAAGGGTTTCAATGACCTT
CTAGCCGAAACGAACCCGG: TAGCCGAAACGAACCCGGC
ACTGATAATCGTCATCCCG: CTGATAATCGTCATCCCGT
CAAGCCGGTTAGCGAAGTT: AAGCCGGTTAGCGAAGTTT
GCTTGTGCGGCTGGGCACT: CTTGTGCGGCTGGGCACTT
TCATAGTTAGTCAAGCCGG: CATAGTTAGTCAAGCCGGT
ACTAGACGTAAGCACAGGT: CTAGACGTAAGCACAGGTC
ACGACACGTAACAGTTGGT: CGACACGTAACAGTTGGTG
AGCGTGCCACACTGACCCA: GCGTGCCACACTGACCCAG
ATTGAGCCGTGATGTAGGA: TTGAGCCGTGATGTAGGAA
TCGTCCAGCCTCCGGCTGC: CGTCCAGCCTCCGGCTGCC
ATATCGCAAAGAGACCGCA: TATCGCAAAGAGACCGCAT
CAAAGTTTTGACTGATCCT: AAAGTTTTGACTGATCCTT
TATCTCAGTGATGCTGGAG: ATCTCAGTGATGCTGGAGC
TATCACGGGTGGGACTAAT: ATCACGGGTGGGACTAATG
AATGGTTCGGCAAGGTACA: ATGGTTCGGCAAGGTACAT
GGGTGGGACTAATGAACAC: GGTGGGACTAATGAACACC
GGAACTGGTAACTTCGAAC: GAACTGGTAACTTCGAACC
GGTGGTATACACCGTAGGC: GTGGTATACACCGTAGGCT
TGAACGGATTATTCGCCTA: GAACGGATTATTCGCCTAC
GTAGCGTCCTTTTCCTTTC: TAGCGTCCTTTTCCTTTCT
GGTCGGCTCACACGACAAT: GTCGGCTCACACGACAATA
TACAGGCCGCAATCAGGCC: ACAGGCCGCAATCAGGCCT
CGGAAAGTTCAAACAGCGT: GGAAAGTTCAAACAGCGTG
AAGCACAGGTCCAAACTAG: AGCACAGGTCCAAACTAGA
ACCTGACTGTACCGCATCA: CCTGACTGTACCGCATCAC
AACAGCGTGATGAGACTTA: ACAGCGTGATGAGACTTAA
GATTTGGTCGAACCCAGCT: ATTTGGTCGAACCCAGCTA
CACGACAATAGAACTCTTG: ACGACAATAGAACTCTTGA
TCCTCTAGATCCTGTGTAC: CCTCTAGATCCTGTGTACT
AGCCGGTTAGCGAAGTTTC: GCCGGTTAGCGAAGTTTCT
CTGTCTCGCTATCTCAGTG: TGTCTCGCTATCTCAGTGA
CAGAGGAAGCCGTGTACCT: AGAGGAAGCCGTGTACCTT
GTGTCTCGGTATATCGCAA: TGTCTCGGTATATCGCAAA
GTGTTCGATCTATTGGAGT: TGTTCGATCTATTGGAGTC
CTCGATTCTCCGAGAGTAC: TCGATTCTCCGAGAGTACT
GATCCTGTGTACTGCCGAT: ATCCTGTGTACTGCCGATA
CCTGATCTAAATCCGGGAA: CTGATCTAAATCCGGGAAG
GCCACGAGGAAAAAACTTG: CCACGAGGAAAAAACTTGG
ACGGAAGCCTCCTGATCTA: CGGAAGCCTCCTGATCTAA
CGATTGCTGCTAGCCGAAA: GATTGCTGCTAGCCGAAAC
CTAGTGTTCACGCTATCGT: TAGTGTTCACGCTATCGTA
AACACTCCACTGGTCAGGT: ACACTCCACTGGTCAGGTC
AACTTCGAACCTGGGGAGA: ACTTCGAACCTGGGGAGAC
GCTGAGGACGAAACTGCCA: CTGAGGACGAAACTGCCAA
GAATGGTTCGGCAAGGTAC: AATGGTTCGGCAAGGTACA
ACGAGGAAAAAACTTGGCT: CGAGGAAAAAACTTGGCTT
AGCGTTACTGCTGACTCCT: GCGTTACTGCTGACTCCTG
TACCTCATTCGTTCGCACA: ACCTCATTCGTTCGCACAA
TCACACGACAATAGAACTC: CACACGACAATAGAACTCT
GTGCACGCTGTGTGGCAGT: TGCACGCTGTGTGGCAGTA
ACGTAAGCTTGTTCTCGTC: CGTAAGCTTGTTCTCGTCT
ATTTGTGAGACATCCTCCT: TTTGTGAGACATCCTCCTC
CTTTCGCTGTCGCGTGGTG: TTTCGCTGTCGCGTGGTGA
TCTATGCTTCGTCCAGCCT: CTATGCTTCGTCCAGCCTC
ATCGGCTGAATTAAACATG: TCGGCTGAATTAAACATGC
GAGGTTTGATCGGGTCTGT: AGGTTTGATCGGGTCTGTC
TTGAACGCTCGAAATTTGT: TGAACGCTCGAAATTTGTG
ACTAGAGTTGGCACTCTTG: CTAGAGTTGGCACTCTTGA
TGACTCAATTGAGCCGTGA: GACTCAATTGAGCCGTGAT
CCGCATGAGAATGGTTCGG: CGCATGAGAATGGTTCGGC
CTCCATCAAGCCTTCTTTC: TCCATCAAGCCTTCTTTCA
CGGACGTAAGCTTGTTCTC: GGACGTAAGCTTGTTCTCG
ACTAATGCATTAGATGACT: CTAATGCATTAGATGACTC
GAGACTTAAAGAGCGTTCC: AGACTTAAAGAGCGTTCCA
CTGTAGGTATCTTTCGGTA: TGTAGGTATCTTTCGGTAC
AGTTCAATGTACCTACGAG: GTTCAATGTACCTACGAGA
CTTCTATCGTTCCCTGCAG: TTCTATCGTTCCCTGCAGT
ACTTAAAGAGCGTTAAACA: CTTAAAGAGCGTTAAACAA
ATCCTCCGGTTTTGAGGAC: TCCTCCGGTTTTGAGGACA
GTGAGGTAGATCCCTCTGC: TGAGGTAGATCCCTCTGCG
TGTCTCGCTATCTCAGTGA: GTCTCGCTATCTCAGTGAT
AGTTTGTCACGGACGTAAG: GTTTGTCACGGACGTAAGC
GATGCACCATATGCTGTTC: ATGCACCATATGCTGTTCA
CCCTCTGCGCATCCTAGAT: CCTCTGCGCATCCTAGATC
CATCCTAGATCATGCCGAA: ATCCTAGATCATGCCGAAG
AGCCTCCTGATCTAAATCC: GCCTCCTGATCTAAATCCG
TGATGCTGGAGCGCCTGGT: GATGCTGGAGCGCCTGGTC
ACGGTAGATGTTGATTAAC: CGGTAGATGTTGATTAACA
CGTGATCCACAGGCGTGCG: GTGATCCACAGGCGTGCGA
TACCACCACACTCCGATGC: ACCACCACACTCCGATGCA
AACGCTCGAAATTTGTGAG: ACGCTCGAAATTTGTGAGA
ACCACTGCTCAGCGTGCCA: CCACTGCTCAGCGTGCCAC
TTTCCTTTCTCTAGTGGGT: TTCCTTTCTCTAGTGGGTA
TTCGCACAAAATGCTTAAG: TCGCACAAAATGCTTAAGG
GCTATCACGGGTGGGACTA: CTATCACGGGTGGGACTAA
GTTCAAACAGCGTGATGAG: TTCAAACAGCGTGATGAGA
GCTTAGTTAGAACCCGATT: CTTAGTTAGAACCCGATTG
GCCGAAGGGTTTCAATGAC: CCGAAGGGTTTCAATGACC
TCAATATCGTCTTTCGCTG: CAATATCGTCTTTCGCTGT
TAGCCCCTGCGAAACGTAA: AGCCCCTGCGAAACGTAAC
AGTGATGCTGGAGCGCCTG: GTGATGCTGGAGCGCCTGG
GCTTTCGTGAGGTAGATCC: CTTTCGTGAGGTAGATCCC
GGACTAATGAACACCGATT: GACTAATGAACACCGATTT
CGAAACTGCCAAAAGTGCA: GAAACTGCCAAAAGTGCAC
CGAAACGTAACAGCACGCC: GAAACGTAACAGCACGCCA
GCCGTGATCCACAGGCGTG: CCGTGATCCACAGGCGTGC
AGTTTATTGCCGCCGATGA: GTTTATTGCCGCCGATGAG
TCCGATGCACCATATGCTG: CCGATGCACCATATGCTGT
CCTCCGGTTTTGAGGACAT: CTCCGGTTTTGAGGACATA
GCTTCGTCCAGCCTCCGGC: CTTCGTCCAGCCTCCGGCT
CTCAGCGGTGTTCGATCTA: TCAGCGGTGTTCGATCTAT
CCGTACACGTATTTCTCTA: CGTACACGTATTTCTCTAG
CTCTGCGCATCCTAGATCA: TCTGCGCATCCTAGATCAT
TGGAGCGCCTGGTCAACTG: GGAGCGCCTGGTCAACTGG
TCTTGATCGGAAAGTTCAA: CTTGATCGGAAAGTTCAAA
TCGATTCAAGGTTATTTGG: CGATTCAAGGTTATTTGGA
GGTGCGTTGCTTAGTTAGA: GTGCGTTGCTTAGTTAGAA
TGAGACGACTACAGCTCCA: GAGACGACTACAGCTCCAT
CGCTGTGTGGCAGTACCCT: GCTGTGTGGCAGTACCCTA
CTCGTCTACAGGCCGCAAT: TCGTCTACAGGCCGCAATC
ACCGACAAACTGAGACGAC: CCGACAAACTGAGACGACT
CTGGTATGTCTCACCACGA: TGGTATGTCTCACCACGAT
AACTAGAGTTGGCACTCTT: ACTAGAGTTGGCACTCTTG
CCAAGCGTCGGGTGGTATA: CAAGCGTCGGGTGGTATAC
GGAGCTAGACTATGAGACT: GAGCTAGACTATGAGACTT
GACTATGAGACTTAAAGAG: ACTATGAGACTTAAAGAGC
CCCTTGACACTAGACGTAA: CCTTGACACTAGACGTAAG
TCGGCCGTGATCCACAGGC: CGGCCGTGATCCACAGGCG
CTGAGACGACTACAGCTCC: TGAGACGACTACAGCTCCA
TCAGTGATGCTGGAGCGCC: CAGTGATGCTGGAGCGCCT
GAGTAGTCATAGTTAGTCA: AGTAGTCATAGTTAGTCAA
CACGTAACAGTTGGTGTCT: ACGTAACAGTTGGTGTCTC
ACAGGTCCAAACTAGAGTT: CAGGTCCAAACTAGAGTTG
TTACACTAAAGTCAAGTTA: TACACTAAAGTCAAGTTAG
AACGGATTATTCGCCTACG: ACGGATTATTCGCCTACGA
AGTCTAGATCTCCGCTGAA: GTCTAGATCTCCGCTGAAA
TCTATCGTTCCCTGCAGTG: CTATCGTTCCCTGCAGTGA
GCAAGGTACATCTCCTGGA: CAAGGTACATCTCCTGGAA
CGCTTGACACACCGACAAA: GCTTGACACACCGACAAAC
CGGAAAGTTTATTGCCGCC: GGAAAGTTTATTGCCGCCG
GCTGGGCACTTCGCGGTCT: CTGGGCACTTCGCGGTCTC
ACGCTGTGTGGCAGTACCC: CGCTGTGTGGCAGTACCCT
AGACCGTCCTGTGCTGACT: GACCGTCCTGTGCTGACTG
CGGCTGAGGACGAAACTGC: GGCTGAGGACGAAACTGCC
GGCTGAATTAAACATGCGC: GCTGAATTAAACATGCGCT
ATATGCTGTTCACCACTAG: TATGCTGTTCACCACTAGC
GCATCCTCCGGTTTTGAGG: CATCCTCCGGTTTTGAGGA
CCCGGCCTGGCACCAACTT: CCGGCCTGGCACCAACTTG
AAACAACATAACCGTTTTG: AACAACATAACCGTTTTGC
TAACTTCGAACCTGGGGAG: AACTTCGAACCTGGGGAGA
GTGTGACAGAGGAAGCCGT: TGTGACAGAGGAAGCCGTG
TCACGGGTGGGACTAATGA: CACGGGTGGGACTAATGAA
TCCTGGAACTGGTAACTTC: CCTGGAACTGGTAACTTCG
CCGGCTGCCCTGTTCACCT: CGGCTGCCCTGTTCACCTG
TTCTAGAACGCGGCTGAGG: TCTAGAACGCGGCTGAGGA
CGAAACGAACCCGGCCTGG: GAAACGAACCCGGCCTGGC
GCCACACTGACCCAGACTG: CCACACTGACCCAGACTGA
AGACATCCTCCTCTATCGG: GACATCCTCCTCTATCGGC
CCTTTCAATATCGTCTTTC: CTTTCAATATCGTCTTTCG
CTATCGTACCTTAACGGAC: TATCGTACCTTAACGGACC
CTTGATCGGAAAGTTTATT: TTGATCGGAAAGTTTATTG
TGAAAGAGGCTTCGGCCGT: GAAAGAGGCTTCGGCCGTG
GAACACCGATTTGGTCGAA: AACACCGATTTGGTCGAAC
TTAAAGAGCGTTACTGCTG: TAAAGAGCGTTACTGCTGA
GAGAGTACTCTTGATCGGA: AGAGTACTCTTGATCGGAA
TACTCAGCGGTGTTCGATC: ACTCAGCGGTGTTCGATCT
TACACTAAAGTCAAGTTAG: ACACTAAAGTCAAGTTAGA
TACTCTTGATCGGAAAGTT: ACTCTTGATCGGAAAGTTT
TATACACCGTAGGCTTAAA: ATACACCGTAGGCTTAAAC
ACTAGCGCATTGCATAGCT: CTAGCGCATTGCATAGCTC
AATAACCGCTACTCGATTC: ATAACCGCTACTCGATTCA
TTAAACAACATAACCGTTT: TAAACAACATAACCGTTTT
TCCACAGGCGTGCGAAGAG: CCACAGGCGTGCGAAGAGT
GGTTATTTGGAAAGGGCAG: GTTATTTGGAAAGGGCAGT
TTGTGCGGCTGCGTAAGAC: TGTGCGGCTGCGTAAGACT
TACATTACGCATCCTCCGG: ACATTACGCATCCTCCGGT
GAGTGTCTGGCCAAGGTCC: AGTGTCTGGCCAAGGTCCT
CTTGATCGGAAAGTTCAAA: TTGATCGGAAAGTTCAAAC
GAAAGTTACGCCCCATACA: AAAGTTACGCCCCATACAT
TTTTCCTTTCTCTAGTGGG: TTTCCTTTCTCTAGTGGGT
GGGAAGTGCGCGTCCGGTG: GGAAGTGCGCGTCCGGTGC
AGGTCTGCGGTGATAGAAG: GGTCTGCGGTGATAGAAGC
ACTACAGCTCCATCAAGCC: CTACAGCTCCATCAAGCCT
CTGGTCAACTGGTATGTCT: TGGTCAACTGGTATGTCTC
TCGCACAGCAAAGTTTTGA: CGCACAGCAAAGTTTTGAC
GTAAGCTTGTTCTCGTCTA: TAAGCTTGTTCTCGTCTAC
GCTGAAACGGTATATCGGG: CTGAAACGGTATATCGGGC
CTCCTGGAACTGGTAACTT: TCCTGGAACTGGTAACTTC
CGAGTAGTCATAGTTAGTC: GAGTAGTCATAGTTAGTCA
GATTTACGGTCCTCTAGAT: ATTTACGGTCCTCTAGATC
TCTGCGCATCCTAGATCAT: CTGCGCATCCTAGATCATG
TCGCACAAAATGCTTAAGG: CGCACAAAATGCTTAAGGG
AGCGAAGTTTCTGAAAGAG: GCGAAGTTTCTGAAAGAGG
GCGCTCGACCTCCCTGTAG: CGCTCGACCTCCCTGTAGG
CAGTTGGTGTCTCGGTATA: AGTTGGTGTCTCGGTATAT
CGAGACCGAGCCACGAACA: GAGACCGAGCCACGAACAC
CGACAATAGAACTCTTGAT: GACAATAGAACTCTTGATC
CCTCCTGATCTAAATCCGG: CTCCTGATCTAAATCCGGG
TATTGCCGCCGATGAGACT: ATTGCCGCCGATGAGACTT
CTACTCGATTCAAGGTTAT: TACTCGATTCAAGGTTATT
GCCCTGTTCACCTGACTGT: CCCTGTTCACCTGACTGTA
CGGCTGCGTAAGACTCTTG: GGCTGCGTAAGACTCTTGA
CTTTCACGATTTACGGTCC: TTTCACGATTTACGGTCCT
GAAAAAACTTGGCTTCTAT: AAAAAACTTGGCTTCTATC
AGACTTAAAGAGCGTTTTA: GACTTAAAGAGCGTTTTAC
AGAGGAAGCCGTGTACCTT: GAGGAAGCCGTGTACCTTC
CGGATTATTCGCCTACGAT: GGATTATTCGCCTACGATC
ACAGTTGGTGTCTCGGTAT: CAGTTGGTGTCTCGGTATA
TTCCAGCGCGTTTTCCAAG: TCCAGCGCGTTTTCCAAGC
AGCGCATTGCATAGCTCTA: GCGCATTGCATAGCTCTAT
TAGAACGCGGCTGAGGACG: AGAACGCGGCTGAGGACGA
CCTTCTTTCACGATTTACG: CTTCTTTCACGATTTACGG
GTTTTGCCTGGAGGATGAA: TTTTGCCTGGAGGATGAAC
CAATATCGTCTTTCGCTGT: AATATCGTCTTTCGCTGTC
GGTATATCGGGCACACTAA: GTATATCGGGCACACTAAG
CCGAGCCACGAACACATGC: CGAGCCACGAACACATGCG
CAGCGGTGTTCGATCTATT: AGCGGTGTTCGATCTATTG
AGAAGCCACGAGGAAAAAA: GAAGCCACGAGGAAAAAAC
GAGACTTAAAGAGCGTTTT: AGACTTAAAGAGCGTTTTA
AGGACATACCAACGGGCGC: GGACATACCAACGGGCGCG
GATTCTCCGAGAGTACTCT: ATTCTCCGAGAGTACTCTT
GGCTCACACGACAATAGAA: GCTCACACGACAATAGAAC
GAAAGTTGTGCGTCATATA: AAAGTTGTGCGTCATATAC
CTAAATCCGGGAAGTGCGC: TAAATCCGGGAAGTGCGCG
ATATACCAAGTTTCGCACC: TATACCAAGTTTCGCACCC
GCTTCTATCGTTCCCTGCA: CTTCTATCGTTCCCTGCAG
AAAGTTGGAGCTAGACTAT: AAGTTGGAGCTAGACTATG
CGTAACAGTTGGTGTCTCG: GTAACAGTTGGTGTCTCGG
TCCCTCTGCGCATCCTAGA: CCCTCTGCGCATCCTAGAT
CATATACCAAGTTTCGCAC: ATATACCAAGTTTCGCACC
GCCTTCTTTCACGATTTAC: CCTTCTTTCACGATTTACG
TTAGAACCCGATTGCTGCT: TAGAACCCGATTGCTGCTA
ACGGACGTAAGCTTGTTCT: CGGACGTAAGCTTGTTCTC
GGGGAGACGCTGGTCGGCT: GGGAGACGCTGGTCGGCTC
CAAACAGCGTGATGAGACT: AAACAGCGTGATGAGACTT
TCTAAATCCGGGAAGTGCG: CTAAATCCGGGAAGTGCGC
GGCGCTAGCAAAGATCCAG: GCGCTAGCAAAGATCCAGT
CGGTCCTCTAGATCCTGTG: GGTCCTCTAGATCCTGTGT
GCTGCAGTACTTCTGGATG: CTGCAGTACTTCTGGATGT
GTCCTGTGCTGACTGACTC: TCCTGTGCTGACTGACTCA
TAAGTAGAAAGTTGTGCGT: AAGTAGAAAGTTGTGCGTC
GTGATGCTGGAGCGCCTGG: TGATGCTGGAGCGCCTGGT
GGTATCTTTCGGTACCAAT: GTATCTTTCGGTACCAATA
ATATCGTCTTTCGCTGTCG: TATCGTCTTTCGCTGTCGC
AAAGGGCAGTCTCGATTCT: AAGGGCAGTCTCGATTCTC
ATGACCTTTCAATATCGTC: TGACCTTTCAATATCGTCT
CATCCTCCTCTATCGGCTG: ATCCTCCTCTATCGGCTGA
GAGACCGAGCCACGAACAC: AGACCGAGCCACGAACACA
CACCACTGCTCAGCGTGCC: ACCACTGCTCAGCGTGCCA
GGAGCGCCTGGTCAACTGG: GAGCGCCTGGTCAACTGGT
TATCGTTCCCTGCAGTGAG: ATCGTTCCCTGCAGTGAGG
GATCGGAAAGTTGGAGCTA: ATCGGAAAGTTGGAGCTAG
AGACTCTTGATCGGAAAGT: GACTCTTGATCGGAAAGTT
TGTGAGACATCCTCCTCTA: GTGAGACATCCTCCTCTAT
TTCTGAAAGAGGCTTCGGC: TCTGAAAGAGGCTTCGGCC
TCTGTCTCGCTATCTCAGT: CTGTCTCGCTATCTCAGTG
CCCTGCAGTGAGGTTTGAT: CCTGCAGTGAGGTTTGATC
TGCGTCATATACCAAGTTT: GCGTCATATACCAAGTTTC
CAATTCGCGAGGTCCGTTT: AATTCGCGAGGTCCGTTTG
TCAAACAGCGTGATGAGAC: CAAACAGCGTGATGAGACT
ATCTCAGTGATGCTGGAGC: TCTCAGTGATGCTGGAGCG
CAATGACCTTTCAATATCG: AATGACCTTTCAATATCGT
CGCATCCTAGATCATGCCG: GCATCCTAGATCATGCCGA
TTACGGCGCTAGCAAAGAT: TACGGCGCTAGCAAAGATC
TTGTTCTCGTCTACAGGCC: TGTTCTCGTCTACAGGCCG
CTGGCACCAACTTGCTTTC: TGGCACCAACTTGCTTTCG
CGCTGCAGTACTTCTGGAT: GCTGCAGTACTTCTGGATG
GGAAAAGCGTCCGACGACA: GAAAAGCGTCCGACGACAC
GTTAAACAACATAACCGTT: TTAAACAACATAACCGTTT
GAGAACGATCTTGAACGCT: AGAACGATCTTGAACGCTC
GCCGAAACGAACCCGGCCT: CCGAAACGAACCCGGCCTG
GAGCGAGAGGATTTACTCA: AGCGAGAGGATTTACTCAG
GGACGAGTGTCTGGCCAAG: GACGAGTGTCTGGCCAAGG
AGTGTGACAGAGGAAGCCG: GTGTGACAGAGGAAGCCGT
CGATCTATTGGAGTCTAGA: GATCTATTGGAGTCTAGAT
GGTGGGACTAATGAACACC: GTGGGACTAATGAACACCG
AAGTTTTGACTGATCCTTA: AGTTTTGACTGATCCTTAA
ACACCGATTTGGTCGAACC: CACCGATTTGGTCGAACCC
GTCCGACGACACGTAACAG: TCCGACGACACGTAACAGT
ACAAAATGCTTAAGGGGTA: CAAAATGCTTAAGGGGTAG
AGTAGTCATAGTTAGTCAA: GTAGTCATAGTTAGTCAAG
GTGGGTAGTCAGTACCACC: TGGGTAGTCAGTACCACCA
AGATCATGCCGAAGGGTTT: GATCATGCCGAAGGGTTTC
TGAGGACATACCAACGGGC: GAGGACATACCAACGGGCG
CTCTAGTGGGTAGTCAGTA: TCTAGTGGGTAGTCAGTAC
CAACGGGCGCGAGTAGTCA: AACGGGCGCGAGTAGTCAT
GGTATATCGCAAAGAGACC: GTATATCGCAAAGAGACCG
CCGCATCACCACTGCTCAG: CGCATCACCACTGCTCAGC
ACTCTTGATCGGAAAGTTA: CTCTTGATCGGAAAGTTAC
TCTCCGCTGAAACGGTATA: CTCCGCTGAAACGGTATAT
CCGCTTGACACACCGACAA: CGCTTGACACACCGACAAA
ATACACCGTAGGCTTAAAC: TACACCGTAGGCTTAAACT
GAACTCTTGATCGGAAAGT: AACTCTTGATCGGAAAGTT
TTCGGTACCAATAAGCTTG: TCGGTACCAATAAGCTTGT
TAAGCTTGTTCTCGTCTAC: AAGCTTGTTCTCGTCTACA
GCCTCCTGATCTAAATCCG: CCTCCTGATCTAAATCCGG
AACATAACCGTTTTGCCTG: ACATAACCGTTTTGCCTGG
TATATCGGGCACACTAAGG: ATATCGGGCACACTAAGGC
TGGGCACTTCGCGGTCTCG: GGGCACTTCGCGGTCTCGG
GAGACATCCTCCTCTATCG: AGACATCCTCCTCTATCGG
CCGTGTACCTTCACGAGCG: CGTGTACCTTCACGAGCGA
AACAGTTGGTGTCTCGGTA: ACAGTTGGTGTCTCGGTAT
TCTCGATTCTCCGAGAGTA: CTCGATTCTCCGAGAGTAC
CATCACCACTGCTCAGCGT: ATCACCACTGCTCAGCGTG
TGTGTACTGCCGATACAAG: GTGTACTGCCGATACAAGT
TGTTCTCGTCTACAGGCCG: GTTCTCGTCTACAGGCCGC
TCCGGCTGCCCTGTTCACC: CCGGCTGCCCTGTTCACCT
TTGGAGTCTAGATCTCCGC: TGGAGTCTAGATCTCCGCT
TGCGGCTGCGTAAGACTCT: GCGGCTGCGTAAGACTCTT
GTCTGGCCAAGGTCCTTGT: TCTGGCCAAGGTCCTTGTT
ACTCTTGATCGGAAAGTTG: CTCTTGATCGGAAAGTTGG
ACTTAAAGAGCGTTCCAGC: CTTAAAGAGCGTTCCAGCG
GTGCGGCTGCGTAAGACTC: TGCGGCTGCGTAAGACTCT
GTAACAGTTGGTGTCTCGG: TAACAGTTGGTGTCTCGGT
GGTACATCTCCTGGAACTG: GTACATCTCCTGGAACTGG
GATCAGTTTGTCACGGACG: ATCAGTTTGTCACGGACGT
CAGCGTGATGAGACTTAAA: AGCGTGATGAGACTTAAAG
CGTTGCTTAGTTAGAACCC: GTTGCTTAGTTAGAACCCG
AAGACTCTTGATCGGAAAG: AGACTCTTGATCGGAAAGT
TGCGCATCCTAGATCATGC: GCGCATCCTAGATCATGCC
CACTTCGCGGTCTCGGTCA: ACTTCGCGGTCTCGGTCAT
CGATTTACGGTCCTCTAGA: GATTTACGGTCCTCTAGAT
TCCTCTATCGGCTGAATTA: CCTCTATCGGCTGAATTAA
TGTCACGGACGTAAGCTTG: GTCACGGACGTAAGCTTGT
AGTTGGAGCTAGACTATGA: GTTGGAGCTAGACTATGAG
CTGGGCACTTCGCGGTCTC: TGGGCACTTCGCGGTCTCG
GGGTAGCGTCCTTTTCCTT: GGTAGCGTCCTTTTCCTTT
CTTAACGGACCTGCTTGTG: TTAACGGACCTGCTTGTGC
ACCTTCACGAGCGAGAGGA: CCTTCACGAGCGAGAGGAT
GCTGCCCTGTTCACCTGAC: CTGCCCTGTTCACCTGACT
CTTTTCCTTTCTCTAGTGG: TTTTCCTTTCTCTAGTGGG
TTGTGCGGCTGGGCACTTC: TGTGCGGCTGGGCACTTCG
CTATGAGACTTAAAGAGCG: TATGAGACTTAAAGAGCGT
ACTCGATTCAAGGTTATTT: CTCGATTCAAGGTTATTTG
GGCTGCCCTGTTCACCTGA: GCTGCCCTGTTCACCTGAC
CTATTCGGACCGCTTGACA: TATTCGGACCGCTTGACAC
AAAGAGGCTTCGGCCGTGA: AAGAGGCTTCGGCCGTGAT
CATAGCTCTATGCTTCGTC: ATAGCTCTATGCTTCGTCC
TATTGGAGTCTAGATCTCC: ATTGGAGTCTAGATCTCCG
CGTCCGACGACACGTAACA: GTCCGACGACACGTAACAG
TAGACTAGTGTTCACGCTA: AGACTAGTGTTCACGCTAT
ACTCAGCGGTGTTCGATCT: CTCAGCGGTGTTCGATCTA
TGCTTCGTCCAGCCTCCGG: GCTTCGTCCAGCCTCCGGC
AAGGTCCTTGTTCTAGAAC: AGGTCCTTGTTCTAGAACG
GTATATCGGGCACACTAAG: TATATCGGGCACACTAAGG
CGAAGTTTCTGAAAGAGGC: GAAGTTTCTGAAAGAGGCT
ACAGCAAAGTTTTGACTGA: CAGCAAAGTTTTGACTGAT
ATCGGAAAGTTCAAACAGC: TCGGAAAGTTCAAACAGCG
CGTGTACCTTCACGAGCGA: GTGTACCTTCACGAGCGAG
AGCGTTACACTAAAGTCAA: GCGTTACACTAAAGTCAAG
CCGAGAGTACTCTTGATCG: CGAGAGTACTCTTGATCGG
GCCAAAAGTGCACGCTGTG: CCAAAAGTGCACGCTGTGT
TCCACTGGTCAGGTCTGCG: CCACTGGTCAGGTCTGCGG
GACACGTAACAGTTGGTGT: ACACGTAACAGTTGGTGTC
TATTTGGAAAGGGCAGTCT: ATTTGGAAAGGGCAGTCTC
CCTACGATCAGTTTGTCAC: CTACGATCAGTTTGTCACG
CATAGTTAGTCAAGCCGGT: ATAGTTAGTCAAGCCGGTT
GCTAGCCGAAACGAACCCG: CTAGCCGAAACGAACCCGG
AGTACCACCACACTCCGAT: GTACCACCACACTCCGATG
TGAAACGGTATATCGGGCA: GAAACGGTATATCGGGCAC
CTGCCGATACAAGTAGTTC: TGCCGATACAAGTAGTTCA
GGCACAATTCGCGAGGTCC: GCACAATTCGCGAGGTCCG
CCTTGACACTAGACGTAAG: CTTGACACTAGACGTAAGC
GGAAAGTTACGCCCCATAC: GAAAGTTACGCCCCATACA
ACTGTACCGCATCACCACT: CTGTACCGCATCACCACTG
TGAGACTACTAATGCATTA: GAGACTACTAATGCATTAG
TTCTCTAGTGGGTAGTCAG: TCTCTAGTGGGTAGTCAGT
GTCATCAGCTATCACGGGT: TCATCAGCTATCACGGGTG
TATACCAAGTTTCGCACCC: ATACCAAGTTTCGCACCCT
AATGACCTTTCAATATCGT: ATGACCTTTCAATATCGTC
TGACACACCGACAAACTGA: GACACACCGACAAACTGAG
GAGACTACTAATGCATTAG: AGACTACTAATGCATTAGA
TCTAGATCTCCGCTGAAAC: CTAGATCTCCGCTGAAACG
CTTGCTTTCGTGAGGTAGA: TTGCTTTCGTGAGGTAGAT
CGAAGAGTAGAACGGTAGA: GAAGAGTAGAACGGTAGAT
CGGTAGATGTTGATTAACA: GGTAGATGTTGATTAACAC
AAGCCTCCTGATCTAAATC: AGCCTCCTGATCTAAATCC
ATTACGGCGCTAGCAAAGA: TTACGGCGCTAGCAAAGAT
AACGGTAGATGTTGATTAA: ACGGTAGATGTTGATTAAC
CTTCACGAGCGAGAGGATT: TTCACGAGCGAGAGGATTT
GATTATTCGCCTACGATCA: ATTATTCGCCTACGATCAG
AAGAGCGTTAAACAACATA: AGAGCGTTAAACAACATAA
ACGTAACAGTTGGTGTCTC: CGTAACAGTTGGTGTCTCG
TGCGCTGCAGTACTTCTGG: GCGCTGCAGTACTTCTGGA
CACCACTAGCGCATTGCAT: ACCACTAGCGCATTGCATA
ACCACACTCCGATGCACCA: CCACACTCCGATGCACCAT
TTAAGACCGTCCTGTGCTG: TAAGACCGTCCTGTGCTGA
GCTTAAACTAGTTAAGTAG: CTTAAACTAGTTAAGTAGA
TGTCGCGTGGTGACAGGAC: GTCGCGTGGTGACAGGACG
ACCTACGAGACCGAGCCAC: CCTACGAGACCGAGCCACG
AAGGTACATCTCCTGGAAC: AGGTACATCTCCTGGAACT
GTAGATGTTGATTAACACT: TAGATGTTGATTAACACTC
ACACTGACCCAGACTGATA: CACTGACCCAGACTGATAA
GTCTACAGGCCGCAATCAG: TCTACAGGCCGCAATCAGG
AGACTTAAAGAGCGTTACT: GACTTAAAGAGCGTTACTG
GATAGAAGCCACGAGGAAA: ATAGAAGCCACGAGGAAAA
GGTTCGGCAAGGTACATCT: GTTCGGCAAGGTACATCTC
CGAACCCGGCCTGGCACCA: GAACCCGGCCTGGCACCAA
CAGGACGAGTGTCTGGCCA: AGGACGAGTGTCTGGCCAA
TCTTGATCGGAAAGTTGGA: CTTGATCGGAAAGTTGGAG
ACTACCTCATTCGTTCGCA: CTACCTCATTCGTTCGCAC
GTTAGTCAAGCCGGTTAGC: TTAGTCAAGCCGGTTAGCG
GTCGGGTGGTATACACCGT: TCGGGTGGTATACACCGTA
CACCGACAAACTGAGACGA: ACCGACAAACTGAGACGAC
GATCATGCCGAAGGGTTTC: ATCATGCCGAAGGGTTTCA
TGAGGTAGATCCCTCTGCG: GAGGTAGATCCCTCTGCGC
CGCGTTTTCCAAGCGTCGG: GCGTTTTCCAAGCGTCGGG
CACCACACTCCGATGCACC: ACCACACTCCGATGCACCA
GTCTTTCGCTGTCGCGTGG: TCTTTCGCTGTCGCGTGGT
CAATAAGCTTGTGCGGCTG: AATAAGCTTGTGCGGCTGC
CAGGCGTGCGAAGAGTAGA: AGGCGTGCGAAGAGTAGAA
TGCGAAACGTAACAGCACG: GCGAAACGTAACAGCACGC
TACCAAGTTTCGCACCCTT: ACCAAGTTTCGCACCCTTC
TGGGTAGTCAGTACCACCA: GGGTAGTCAGTACCACCAC
GATTAACACTCCACTGGTC: ATTAACACTCCACTGGTCA
CGAGAGGATTTACTCAGCG: GAGAGGATTTACTCAGCGG
ACACGTATTTCTCTAGGAT: CACGTATTTCTCTAGGATA
CGCATCCTCCGGTTTTGAG: GCATCCTCCGGTTTTGAGG
TGACTGTACCGCATCACCA: GACTGTACCGCATCACCAC
CATGCCGAAGGGTTTCAAT: ATGCCGAAGGGTTTCAATG
GTGATGTAGGAAAAGCGTC: TGATGTAGGAAAAGCGTCC
CTACGAGACCGAGCCACGA: TACGAGACCGAGCCACGAA
TCGGAAAGTTCAAACAGCG: CGGAAAGTTCAAACAGCGT
CCCTTCAACTCTACATTAC: CCTTCAACTCTACATTACG
CTGATCCTTAAGACCGTCC: TGATCCTTAAGACCGTCCT
GACGAAACTGCCAAAAGTG: ACGAAACTGCCAAAAGTGC
GTTTTACTACCTCATTCGT: TTTTACTACCTCATTCGTT
AGGTAGATCCCTCTGCGCA: GGTAGATCCCTCTGCGCAT
AAGGGTTTCAATGACCTTT: AGGGTTTCAATGACCTTTC
CGCTCGACCTCCCTGTAGG: GCTCGACCTCCCTGTAGGT
AGACTGATAATCGTCATCC: GACTGATAATCGTCATCCC
GTACCCTACCTAGCGTTAC: TACCCTACCTAGCGTTACA
ACTCAAAGTGTGACAGAGG: CTCAAAGTGTGACAGAGGA
TGCAGTGAGGTTTGATCGG: GCAGTGAGGTTTGATCGGG
GCTAGCAAAGATCCAGTCC: CTAGCAAAGATCCAGTCCC
CGTAAGCTTGTTCTCGTCT: GTAAGCTTGTTCTCGTCTA
CGTACCTTAACGGACCTGC: GTACCTTAACGGACCTGCT
TTGACTGATCCTTAAGACC: TGACTGATCCTTAAGACCG
ACTGCTGACTCCTGGCACA: CTGCTGACTCCTGGCACAA
ATATAGCCCCTGCGAAACG: TATAGCCCCTGCGAAACGT
TAGAAAGTTGTGCGTCATA: AGAAAGTTGTGCGTCATAT
TGACCCAGACTGATAATCG: GACCCAGACTGATAATCGT
TGCGCTCGACCTCCCTGTA: GCGCTCGACCTCCCTGTAG
AATGCATTAGATGACTCAA: ATGCATTAGATGACTCAAT
CAACTTGCTTTCGTGAGGT: AACTTGCTTTCGTGAGGTA
GTCAAGTTAGACTAGTGTT: TCAAGTTAGACTAGTGTTC
TACTCGATTCAAGGTTATT: ACTCGATTCAAGGTTATTT
CTGACCCAGACTGATAATC: TGACCCAGACTGATAATCG
CTCCCTGTAGGTATCTTTC: TCCCTGTAGGTATCTTTCG
CTCGATTCAAGGTTATTTG: TCGATTCAAGGTTATTTGG
GTACTTCTGGATGTCAATA: TACTTCTGGATGTCAATAA
TACGGCGCTAGCAAAGATC: ACGGCGCTAGCAAAGATCC
GTGAGACATCCTCCTCTAT: TGAGACATCCTCCTCTATC
TTCGCCTACGATCAGTTTG: TCGCCTACGATCAGTTTGT
TAGATCATGCCGAAGGGTT: AGATCATGCCGAAGGGTTT
CAATAACCGCTACTCGATT: AATAACCGCTACTCGATTC
CCGTAGGCTTAAACTAGTT: CGTAGGCTTAAACTAGTTA
CTACTAATGCATTAGATGA: TACTAATGCATTAGATGAC
TCTCTAGGATATAGCCCCT: CTCTAGGATATAGCCCCTG
TGATCGGAAAGTTCAAACA: GATCGGAAAGTTCAAACAG
TGCTGCTAGCCGAAACGAA: GCTGCTAGCCGAAACGAAC
CTGACTCCTGGCACAATTC: TGACTCCTGGCACAATTCG
CCTCATTCGTTCGCACAAA: CTCATTCGTTCGCACAAAA
TAGATGACTCAATTGAGCC: AGATGACTCAATTGAGCCG
GGTCCAAACTAGAGTTGGC: GTCCAAACTAGAGTTGGCA
CATCCCGTACACGTATTTC: ATCCCGTACACGTATTTCT
TACATCTCCTGGAACTGGT: ACATCTCCTGGAACTGGTA
ATCGGAAAGTTGGAGCTAG: TCGGAAAGTTGGAGCTAGA
AAGAGCGTTACTGCTGACT: AGAGCGTTACTGCTGACTC
TCGGTATATCGCAAAGAGA: CGGTATATCGCAAAGAGAC
TTAGTTAGAACCCGATTGC: TAGTTAGAACCCGATTGCT
AGATGACTCAATTGAGCCG: GATGACTCAATTGAGCCGT
ATGCACCATATGCTGTTCA: TGCACCATATGCTGTTCAC
TCAAAGTGTGACAGAGGAA: CAAAGTGTGACAGAGGAAG
CCTGGCACCAACTTGCTTT: CTGGCACCAACTTGCTTTC
AAGCCGGTTAGCGAAGTTT: AGCCGGTTAGCGAAGTTTC
GATCTAAATCCGGGAAGTG: ATCTAAATCCGGGAAGTGC
CGGTCTCGGTCATCAGCTA: GGTCTCGGTCATCAGCTAT
AACACCGATTTGGTCGAAC: ACACCGATTTGGTCGAACC
CCTTAAGACCGTCCTGTGC: CTTAAGACCGTCCTGTGCT
TCGGACCGCTTGACACACC: CGGACCGCTTGACACACCG
CGAACCTGGGGAGACGCTG: GAACCTGGGGAGACGCTGG
TATCGGCTGAATTAAACAT: ATCGGCTGAATTAAACATG
TAAGACCGTCCTGTGCTGA: AAGACCGTCCTGTGCTGAC
TCATGCCGAAGGGTTTCAA: CATGCCGAAGGGTTTCAAT
CCTGACTGTACCGCATCAC: CTGACTGTACCGCATCACC
TCCTAGATCATGCCGAAGG: CCTAGATCATGCCGAAGGG
AAGTTGGAGCTAGACTATG: AGTTGGAGCTAGACTATGA
AGAGCGTTCCAGCGCGTTT: GAGCGTTCCAGCGCGTTTT
ACTAATGAACACCGATTTG: CTAATGAACACCGATTTGG
GCACGCTGTGTGGCAGTAC: CACGCTGTGTGGCAGTACC
ATGCTTAAGGGGTAGCGTC: TGCTTAAGGGGTAGCGTCC
TCTAGGATATAGCCCCTGC: CTAGGATATAGCCCCTGCG
CAGTACCCTACCTAGCGTT: AGTACCCTACCTAGCGTTA
TCTTGAACGCTCGAAATTT: CTTGAACGCTCGAAATTTG
GCATCCTAGATCATGCCGA: CATCCTAGATCATGCCGAA
CGGAAGCCTCCTGATCTAA: GGAAGCCTCCTGATCTAAA
ACCCTACCTAGCGTTACAC: CCCTACCTAGCGTTACACT
CTTAAGGGGTAGCGTCCTT: TTAAGGGGTAGCGTCCTTT
TACCTTCACGAGCGAGAGG: ACCTTCACGAGCGAGAGGA
CTAGATCATGCCGAAGGGT: TAGATCATGCCGAAGGGTT
TAGTCAGTACCACCACACT: AGTCAGTACCACCACACTC
TCACCACTGCTCAGCGTGC: CACCACTGCTCAGCGTGCC
GATACAAGTAGTTCAATGT: ATACAAGTAGTTCAATGTA
AGTAGAACGGTAGATGTTG: GTAGAACGGTAGATGTTGA
GTGATGAGACTTAAAGAGC: TGATGAGACTTAAAGAGCG
TGAGGACGAAACTGCCAAA: GAGGACGAAACTGCCAAAA
CCACTGCTCAGCGTGCCAC: CACTGCTCAGCGTGCCACA
CGACCTCCCTGTAGGTATC: GACCTCCCTGTAGGTATCT
CGTCTACAGGCCGCAATCA: GTCTACAGGCCGCAATCAG
